id;transaction_date;quantity_sold;start_of_day;waste;waste_percentage;sales_outlet_id;product_id
1;20.02.2020;22;62;40;35;3616;2273
2;01.04.2019;88;95;7;92;4122;168
3;25.05.2019;87;123;36;70;4587;923
4;07.01.2020;92;94;2;97;2097;2780
5;12.06.2019;46;86;40;53;2208;127
6;14.09.2019;73;80;7;91;672;4058
7;05.11.2019;71;104;33;68;2209;2653
8;11.10.2019;20;59;39;33;2769;3549
9;04.07.2019;49;71;22;69;1611;4297
10;15.11.2019;47;84;37;55;258;3116
11;05.04.2019;87;97;10;89;2196;1105
12;24.10.2019;2;30;28;6;285;1891
13;31.01.2020;53;85;32;62;1367;927
14;16.08.2019;34;46;12;73;543;576
15;21.04.2019;6;16;10;37;223;504
16;09.10.2019;8;38;30;21;609;2791
17;30.12.2019;7;16;9;43;429;4838
18;26.06.2019;36;64;28;56;4704;1042
19;30.11.2019;42;78;36;53;3896;2112
20;11.02.2020;100;131;31;76;52;2171
21;20.06.2019;70;101;31;69;1936;2765
22;29.10.2019;42;71;29;59;551;3795
23;20.07.2019;25;36;11;69;3778;3014
24;11.11.2019;48;70;22;68;3671;4295
25;21.11.2019;23;36;13;63;2305;628
26;30.04.2019;87;107;20;81;4674;1831
27;14.07.2019;40;67;27;59;2984;706
28;02.04.2019;18;55;37;32;3455;95
29;11.07.2019;99;108;9;91;3764;380
30;30.10.2019;19;33;14;57;1178;2405
31;01.03.2020;99;128;29;77;2025;4611
32;24.10.2019;10;26;16;38;1549;4284
33;11.10.2019;40;75;35;53;4412;960
34;23.01.2020;12;24;12;50;2825;28
35;03.04.2019;92;94;2;97;4288;4576
36;28.06.2019;58;60;2;96;1875;1343
37;23.03.2020;96;100;4;96;769;144
38;15.04.2019;79;116;37;68;2938;1661
39;21.01.2020;62;92;30;67;1304;1829
40;02.03.2020;4;18;14;22;2203;4969
41;30.08.2019;43;65;22;66;2216;214
42;03.01.2020;78;82;4;95;3287;1671
43;04.06.2019;79;88;9;89;1546;2683
44;03.11.2019;41;66;25;62;3528;896
45;07.03.2020;63;82;19;76;3270;4157
46;05.05.2019;95;126;31;75;2663;1339
47;06.02.2020;91;104;13;87;733;3901
48;09.11.2019;55;92;37;59;526;1801
49;31.07.2019;19;42;23;45;1352;3766
50;09.07.2019;76;111;35;68;214;1347
51;15.07.2019;50;67;17;74;3912;2865
52;16.06.2019;72;81;9;88;3004;3082
53;09.03.2020;21;39;18;53;3299;3716
54;23.04.2019;68;102;34;66;3754;3392
55;02.02.2020;52;55;3;94;929;2012
56;06.12.2019;74;86;12;86;1287;1463
57;10.11.2019;92;103;11;89;890;3505
58;12.12.2019;89;114;25;78;4372;122
59;01.12.2019;82;109;27;75;2915;4687
60;16.10.2019;2;3;1;66;1332;1255
61;07.04.2019;63;77;14;81;1413;1317
62;23.09.2019;38;73;35;52;2058;2681
63;09.07.2019;34;40;6;85;4167;190
64;16.05.2019;24;43;19;55;351;2135
65;12.08.2019;69;103;34;66;3889;1226
66;10.12.2019;50;65;15;76;2463;4149
67;16.03.2020;44;71;27;61;4376;4497
68;23.03.2020;84;100;16;84;4627;2213
69;01.09.2019;41;43;2;95;1612;4570
70;04.05.2019;28;49;21;57;885;2767
71;21.09.2019;67;71;4;94;4439;3103
72;06.06.2019;69;107;38;64;787;744
73;07.12.2019;82;114;32;71;2757;3071
74;16.09.2019;84;109;25;77;4811;918
75;31.05.2019;71;98;27;72;1946;1373
76;24.11.2019;95;124;29;76;4505;368
77;03.05.2019;90;99;9;90;4014;3567
78;07.02.2020;77;80;3;96;12;4017
79;25.02.2020;76;95;19;80;156;4723
80;26.10.2019;16;46;30;34;1726;3844
81;08.10.2019;5;12;7;41;4262;4699
82;08.02.2020;20;52;32;38;192;3042
83;13.12.2019;31;38;7;81;1684;697
84;10.06.2019;89;103;14;86;687;3134
85;18.05.2019;12;36;24;33;4345;1196
86;19.03.2020;9;28;19;32;1575;856
87;11.08.2019;65;83;18;78;4631;3893
88;08.04.2019;41;72;31;56;270;2214
89;05.04.2019;56;93;37;60;1474;102
90;31.12.2019;21;53;32;39;1523;4546
91;05.04.2019;54;60;6;90;3287;4080
92;11.04.2019;77;107;30;71;4852;3102
93;24.07.2019;2;37;35;5;378;2004
94;21.10.2019;82;89;7;92;4902;3246
95;19.01.2020;78;110;32;70;1887;2223
96;01.01.2020;67;73;6;91;4839;1180
97;01.02.2020;70;102;32;68;2013;1101
98;20.11.2019;38;78;40;48;1851;1650
99;20.03.2020;17;56;39;30;4738;2568
100;28.03.2020;91;99;8;91;1945;2345
101;14.01.2020;61;86;25;70;2858;2432
102;10.05.2019;97;104;7;93;1907;4507
103;16.06.2019;73;100;27;73;2249;3946
104;14.06.2019;66;86;20;76;1383;3703
105;31.01.2020;31;33;2;93;1353;1175
106;26.09.2019;12;31;19;38;6;4942
107;31.05.2019;70;86;16;81;3284;3597
108;03.11.2019;32;71;39;45;1923;3777
109;02.07.2019;33;41;8;80;2812;124
110;01.01.2020;46;77;31;59;107;4388
111;31.07.2019;68;102;34;66;4427;260
112;07.06.2019;8;26;18;30;4676;4076
113;10.05.2019;16;36;20;44;1617;4496
114;17.09.2019;51;77;26;66;307;779
115;19.11.2019;14;35;21;40;2913;363
116;20.10.2019;98;129;31;75;4680;706
117;13.01.2020;64;76;12;84;762;4603
118;08.12.2019;26;47;21;55;2544;1734
119;31.03.2019;98;118;20;83;3830;4689
120;05.12.2019;95;135;40;70;832;786
121;18.06.2019;57;86;29;66;32;3369
122;09.01.2020;34;48;14;70;2435;2702
123;25.03.2020;14;32;18;43;3710;214
124;06.09.2019;59;60;1;98;3936;4357
125;03.07.2019;89;105;16;84;729;3782
126;03.05.2019;82;100;18;82;1957;1661
127;24.11.2019;63;101;38;62;3315;4921
128;15.04.2019;44;64;20;68;889;4396
129;24.11.2019;46;50;4;92;3597;3344
130;22.08.2019;18;28;10;64;4500;112
131;18.12.2019;100;111;11;90;2089;4642
132;25.06.2019;8;29;21;27;3476;878
133;10.02.2020;6;24;18;25;2972;2868
134;24.09.2019;6;11;5;54;1419;2337
135;30.07.2019;94;125;31;75;2904;3652
136;08.04.2019;67;91;24;73;449;1855
137;06.07.2019;52;61;9;85;3372;3091
138;14.12.2019;10;28;18;35;1417;2034
139;07.06.2019;92;108;16;85;3059;1380
140;12.03.2020;5;10;5;50;48;1085
141;14.12.2019;91;105;14;86;728;1910
142;26.06.2019;27;65;38;41;2379;4082
143;19.07.2019;52;61;9;85;4622;867
144;11.09.2019;37;39;2;94;1466;3677
145;16.01.2020;3;25;22;12;2921;187
146;15.05.2019;1;26;25;3;4665;4508
147;21.07.2019;97;108;11;89;3360;3103
148;14.01.2020;89;118;29;75;3815;2790
149;04.03.2020;9;10;1;90;433;4248
150;16.10.2019;34;40;6;85;2269;2835
151;26.01.2020;82;84;2;97;790;3958
152;11.12.2019;55;87;32;63;1566;309
153;08.06.2019;55;89;34;61;2370;1861
154;23.03.2020;41;57;16;71;4531;2165
155;06.05.2019;36;59;23;61;4766;1504
156;25.10.2019;93;122;29;76;4591;4850
157;11.08.2019;28;34;6;82;774;1359
158;27.10.2019;88;124;36;70;115;4436
159;18.09.2019;25;50;25;50;4616;4195
160;26.06.2019;53;68;15;77;3556;2373
161;13.04.2019;60;97;37;61;3094;4478
162;20.12.2019;93;132;39;70;1343;1492
163;03.12.2019;53;85;32;62;3722;2416
164;11.06.2019;4;31;27;12;434;181
165;09.11.2019;56;81;25;69;3112;104
166;15.08.2019;48;55;7;87;4781;1204
167;04.12.2019;47;55;8;85;1268;2356
168;13.07.2019;40;44;4;90;2763;556
169;01.05.2019;35;54;19;64;1108;1318
170;15.10.2019;80;103;23;77;1294;1444
171;01.08.2019;90;101;11;89;4983;1049
172;01.04.2019;66;84;18;78;2272;3492
173;14.11.2019;25;58;33;43;2861;2168
174;17.05.2019;72;76;4;94;729;2935
175;06.03.2020;3;41;38;7;237;2825
176;09.03.2020;16;50;34;32;221;1918
177;20.08.2019;77;105;28;73;2078;4182
178;19.09.2019;65;95;30;68;3021;3216
179;28.02.2020;10;22;12;45;4125;518
180;10.04.2019;2;32;30;6;2691;395
181;11.09.2019;61;69;8;88;2291;108
182;25.09.2019;18;44;26;40;1956;4586
183;20.10.2019;100;104;4;96;502;4908
184;13.09.2019;61;64;3;95;240;3895
185;28.08.2019;23;24;1;95;3611;1244
186;03.08.2019;41;71;30;57;3969;3694
187;27.12.2019;32;50;18;64;1373;3259
188;26.07.2019;95;122;27;77;1102;3032
189;25.06.2019;10;40;30;25;3385;653
190;05.01.2020;58;80;22;72;4455;3225
191;01.11.2019;60;61;1;98;380;2270
192;26.04.2019;31;65;34;47;4706;4687
193;26.07.2019;51;60;9;85;2894;1591
194;28.06.2019;65;87;22;74;2750;4145
195;11.07.2019;72;87;15;82;4990;3188
196;19.11.2019;84;88;4;95;2013;1370
197;24.12.2019;95;120;25;79;1642;952
198;30.09.2019;93;125;32;74;3539;4854
199;10.08.2019;34;48;14;70;3163;3846
200;28.10.2019;83;102;19;81;755;1943
201;30.04.2019;85;120;35;70;4455;594
202;06.12.2019;45;76;31;59;3322;308
203;10.08.2019;47;86;39;54;1215;3558
204;27.01.2020;99;138;39;71;4115;3278
205;18.09.2019;39;43;4;90;757;2115
206;06.05.2019;78;86;8;90;391;2482
207;26.10.2019;42;63;21;66;3668;103
208;03.05.2019;83;95;12;87;3593;954
209;09.06.2019;79;105;26;75;1702;4575
210;01.09.2019;66;105;39;62;1481;4295
211;27.10.2019;46;67;21;68;1595;4679
212;28.12.2019;39;69;30;56;1571;3737
213;26.12.2019;79;100;21;79;4319;3848
214;08.03.2020;35;72;37;48;51;434
215;29.01.2020;65;87;22;74;2376;4603
216;28.08.2019;84;112;28;75;4678;184
217;13.02.2020;81;118;37;68;1261;3418
218;05.12.2019;48;81;33;59;3917;4627
219;23.11.2019;35;40;5;87;1119;3183
220;15.11.2019;58;75;17;77;4163;1949
221;25.01.2020;16;24;8;66;2450;73
222;13.04.2019;95;104;9;91;301;3818
223;13.07.2019;45;47;2;95;1974;4901
224;16.05.2019;67;92;25;72;2334;3731
225;19.11.2019;37;51;14;72;1025;651
226;08.07.2019;69;87;18;79;1930;3515
227;24.12.2019;25;47;22;53;3632;124
228;08.10.2019;86;125;39;68;3245;4578
229;29.04.2019;47;55;8;85;2520;633
230;14.03.2020;97;101;4;96;2936;3482
231;06.02.2020;92;109;17;84;108;4904
232;15.04.2019;12;43;31;27;1020;3597
233;22.12.2019;39;73;34;53;1069;1099
234;24.08.2019;51;74;23;68;248;1845
235;21.08.2019;31;48;17;64;3616;3411
236;15.09.2019;74;76;2;97;4007;2406
237;11.09.2019;39;58;19;67;1405;1376
238;26.11.2019;67;74;7;90;2419;126
239;31.05.2019;50;59;9;84;4682;3593
240;19.08.2019;73;104;31;70;3710;2134
241;22.08.2019;61;81;20;75;3406;209
242;10.07.2019;77;83;6;92;3357;2081
243;02.01.2020;24;39;15;61;3997;2817
244;10.07.2019;39;40;1;97;1579;2133
245;02.02.2020;100;119;19;84;2120;4157
246;25.01.2020;12;51;39;23;4884;4427
247;28.03.2020;97;105;8;92;815;1065
248;03.04.2019;84;94;10;89;1807;3846
249;26.12.2019;46;58;12;79;4199;4781
250;15.07.2019;29;60;31;48;4667;3624
251;14.03.2020;82;85;3;96;849;1588
252;26.04.2019;89;108;19;82;2669;574
253;30.11.2019;83;117;34;70;3608;3111
254;10.01.2020;23;44;21;52;4936;190
255;24.07.2019;16;27;11;59;4751;2230
256;14.03.2020;32;59;27;54;2405;3190
257;27.11.2019;73;75;2;97;2067;4065
258;01.08.2019;88;95;7;92;3366;3186
259;31.03.2019;33;38;5;86;550;4265
260;12.12.2019;39;51;12;76;740;326
261;05.04.2019;69;82;13;84;31;3687
262;07.12.2019;8;21;13;38;3608;4370
263;18.12.2019;58;86;28;67;103;318
264;18.10.2019;81;106;25;76;4024;1390
265;28.12.2019;67;106;39;63;4579;3636
266;27.07.2019;80;114;34;70;167;82
267;29.09.2019;98;104;6;94;1675;4453
268;10.11.2019;96;131;35;73;3649;3888
269;19.04.2019;9;41;32;21;1811;3936
270;28.05.2019;54;90;36;60;694;150
271;12.03.2020;52;88;36;59;4641;1942
272;30.05.2019;99;127;28;77;459;2862
273;04.04.2019;13;34;21;38;4716;4465
274;13.10.2019;87;123;36;70;1958;4232
275;15.04.2019;18;44;26;40;2693;2377
276;08.02.2020;10;21;11;47;198;2287
277;05.06.2019;65;73;8;89;2801;2154
278;17.08.2019;70;91;21;76;4201;1288
279;11.01.2020;42;45;3;93;1179;3989
280;08.04.2019;20;21;1;95;709;1184
281;18.09.2019;37;74;37;50;215;2981
282;23.07.2019;58;96;38;60;730;4200
283;26.05.2019;78;111;33;70;1019;794
284;04.11.2019;76;116;40;65;4529;4342
285;14.12.2019;55;80;25;68;2371;3810
286;25.04.2019;94;111;17;84;144;4263
287;21.10.2019;54;56;2;96;153;3485
288;01.09.2019;82;94;12;87;600;3081
289;13.02.2020;35;58;23;60;3620;1025
290;29.12.2019;28;55;27;50;3043;4777
291;18.09.2019;34;47;13;72;2363;4534
292;30.01.2020;73;109;36;66;1795;1839
293;06.05.2019;15;31;16;48;3607;4901
294;04.09.2019;73;98;25;74;3732;3242
295;28.11.2019;77;105;28;73;1330;64
296;15.02.2020;11;12;1;91;1983;3593
297;19.03.2020;49;74;25;66;2536;869
298;27.03.2020;84;97;13;86;3533;3562
299;17.02.2020;54;82;28;65;4229;422
300;19.02.2020;24;55;31;43;243;2652
301;21.05.2019;11;43;32;25;4092;3163
302;03.11.2019;2;4;2;50;1539;3114
303;18.01.2020;17;25;8;68;3100;791
304;10.01.2020;70;81;11;86;4671;2021
305;22.05.2019;100;115;15;86;1206;3604
306;18.02.2020;3;15;12;20;4435;1982
307;21.03.2020;5;12;7;41;1289;623
308;24.06.2019;57;76;19;75;1851;4613
309;14.01.2020;74;86;12;86;900;25
310;20.07.2019;96;121;25;79;24;3394
311;14.07.2019;79;95;16;83;4521;357
312;31.10.2019;24;41;17;58;1727;4367
313;04.05.2019;46;63;17;73;3916;3133
314;12.06.2019;43;50;7;86;3935;4058
315;23.06.2019;17;20;3;85;2226;329
316;24.12.2019;59;60;1;98;2561;1250
317;03.07.2019;3;5;2;60;2418;1165
318;23.08.2019;22;59;37;37;3449;3414
319;17.06.2019;10;39;29;25;1616;3491
320;13.03.2020;27;45;18;60;2117;953
321;14.08.2019;45;55;10;81;659;2381
322;10.05.2019;98;122;24;80;2565;2899
323;02.10.2019;59;97;38;60;1901;4717
324;19.02.2020;1;20;19;5;940;3283
325;06.04.2019;78;110;32;70;2974;1919
326;12.11.2019;9;47;38;19;2064;1965
327;02.07.2019;44;71;27;61;4130;26
328;30.11.2019;95;129;34;73;4494;3190
329;14.05.2019;97;123;26;78;1325;4827
330;26.06.2019;15;37;22;40;1537;2724
331;06.02.2020;49;69;20;71;1953;472
332;16.03.2020;48;63;15;76;4005;2099
333;09.04.2019;61;96;35;63;3429;2854
334;01.05.2019;98;128;30;76;3429;1574
335;24.09.2019;39;58;19;67;513;542
336;06.07.2019;36;55;19;65;809;907
337;19.07.2019;13;38;25;34;984;450
338;23.09.2019;57;77;20;74;463;4320
339;19.03.2020;47;68;21;69;3206;3887
340;08.12.2019;59;74;15;79;2651;29
341;21.09.2019;14;46;32;30;3307;3451
342;08.11.2019;99;119;20;83;1719;39
343;05.08.2019;93;131;38;70;1157;1069
344;18.04.2019;34;45;11;75;3428;934
345;14.09.2019;74;77;3;96;865;166
346;05.03.2020;9;38;29;23;60;2391
347;20.09.2019;41;44;3;93;4801;2281
348;14.07.2019;73;80;7;91;1168;1597
349;05.11.2019;9;15;6;60;1893;1479
350;15.08.2019;83;90;7;92;3104;3916
351;21.02.2020;74;80;6;92;1360;1707
352;19.03.2020;62;99;37;62;4355;1281
353;01.03.2020;25;35;10;71;2901;4564
354;08.10.2019;67;73;6;91;3588;3772
355;07.04.2019;4;16;12;25;503;2812
356;06.08.2019;76;96;20;79;4413;4289
357;08.05.2019;64;85;21;75;51;3896
358;07.05.2019;40;63;23;63;3793;3134
359;02.08.2019;40;59;19;67;3818;1309
360;09.04.2019;24;57;33;42;4498;2747
361;25.03.2020;79;88;9;89;2702;2280
362;13.03.2020;63;94;31;67;2679;654
363;21.01.2020;22;57;35;38;1174;3326
364;14.05.2019;52;71;19;73;4274;1968
365;20.06.2019;71;73;2;97;1598;3135
366;13.01.2020;8;30;22;26;3967;4606
367;29.05.2019;74;109;35;67;139;3169
368;09.01.2020;77;100;23;77;4535;190
369;05.05.2019;64;90;26;71;4189;593
370;05.03.2020;9;36;27;25;1974;1518
371;26.01.2020;86;111;25;77;538;1644
372;27.08.2019;79;100;21;79;1633;1105
373;05.06.2019;56;78;22;71;4627;4353
374;20.02.2020;72;111;39;64;2118;3307
375;11.08.2019;14;34;20;41;3737;3370
376;17.03.2020;54;94;40;57;2501;1333
377;20.02.2020;48;60;12;80;581;3386
378;21.08.2019;3;41;38;7;2811;1240
379;26.11.2019;67;107;40;62;3271;2362
380;04.01.2020;87;88;1;98;504;500
381;25.11.2019;27;59;32;45;916;1688
382;17.02.2020;79;98;19;80;2965;2988
383;09.01.2020;26;51;25;50;285;2972
384;16.07.2019;4;17;13;23;814;4005
385;16.08.2019;59;68;9;86;3481;3368
386;01.11.2019;52;63;11;82;154;2888
387;11.11.2019;61;68;7;89;921;3252
388;22.08.2019;1;34;33;2;3975;4803
389;17.03.2020;16;45;29;35;2;1765
390;08.02.2020;24;32;8;75;4086;3379
391;13.05.2019;95;106;11;89;2038;4593
392;20.06.2019;6;26;20;23;3120;3362
393;18.12.2019;57;69;12;82;3987;218
394;08.11.2019;94;120;26;78;2784;1888
395;26.12.2019;14;27;13;51;6;4340
396;07.01.2020;44;71;27;61;993;3993
397;04.10.2019;17;43;26;39;3517;1442
398;15.02.2020;86;104;18;82;2585;2094
399;22.11.2019;50;78;28;64;285;1926
400;23.07.2019;13;26;13;50;4007;4028
401;24.11.2019;23;53;30;43;4595;3143
402;20.11.2019;45;82;37;54;4434;3670
403;14.04.2019;32;39;7;82;3775;105
404;19.02.2020;31;42;11;73;1434;3615
405;25.04.2019;1;14;13;7;2008;4011
406;24.02.2020;4;27;23;14;1330;2613
407;21.04.2019;28;44;16;63;1154;3688
408;03.12.2019;21;40;19;52;2153;4310
409;17.07.2019;96;97;1;98;1551;447
410;28.04.2019;31;65;34;47;4074;4804
411;24.01.2020;25;57;32;43;109;3228
412;12.10.2019;14;36;22;38;280;2328
413;28.05.2019;59;63;4;93;2856;77
414;09.10.2019;17;42;25;40;4268;1905
415;03.11.2019;88;93;5;94;4295;4002
416;24.01.2020;85;92;7;92;4033;3416
417;31.10.2019;8;26;18;30;4196;158
418;17.08.2019;49;52;3;94;1665;1795
419;23.12.2019;37;58;21;63;3231;2270
420;04.03.2020;62;76;14;81;4679;2735
421;20.04.2019;56;68;12;82;2040;2734
422;25.09.2019;93;108;15;86;4618;663
423;05.11.2019;45;81;36;55;3408;3317
424;11.03.2020;69;93;24;74;2427;4503
425;13.02.2020;60;65;5;92;2416;2928
426;08.09.2019;43;51;8;84;4797;786
427;16.12.2019;92;122;30;75;4453;4264
428;20.01.2020;69;99;30;69;3237;4393
429;26.04.2019;57;76;19;75;3012;2382
430;23.07.2019;52;83;31;62;1296;3894
431;02.01.2020;14;54;40;25;4458;255
432;20.05.2019;62;102;40;60;52;4038
433;21.03.2020;40;45;5;88;891;3745
434;09.08.2019;62;97;35;63;366;1636
435;09.04.2019;30;62;32;48;4661;3389
436;30.07.2019;72;89;17;80;3947;2764
437;15.09.2019;54;85;31;63;4314;3220
438;28.09.2019;18;30;12;60;828;2606
439;08.01.2020;30;40;10;75;637;3706
440;10.09.2019;19;30;11;63;4793;2321
441;19.12.2019;69;80;11;86;4253;1263
442;18.08.2019;64;81;17;79;3202;2828
443;18.05.2019;82;113;31;72;2566;3058
444;15.02.2020;54;85;31;63;2473;1628
445;21.11.2019;77;82;5;93;1709;1281
446;11.06.2019;69;96;27;71;294;2972
447;08.01.2020;36;52;16;69;1487;2262
448;18.12.2019;3;21;18;14;1257;743
449;30.06.2019;95;134;39;70;228;2761
450;28.12.2019;68;78;10;87;4197;275
451;22.03.2020;86;110;24;78;1866;3330
452;07.03.2020;96;122;26;78;659;2549
453;25.12.2019;69;96;27;71;1411;4261
454;26.10.2019;71;107;36;66;2615;4652
455;08.10.2019;44;57;13;77;2700;1998
456;11.09.2019;54;58;4;93;1812;4927
457;21.10.2019;14;46;32;30;3132;2199
458;29.10.2019;34;60;26;56;3326;2583
459;13.10.2019;8;17;9;47;1967;3468
460;21.02.2020;12;51;39;23;3868;3502
461;08.05.2019;72;93;21;77;4296;2843
462;04.02.2020;44;64;20;68;4221;2455
463;15.04.2019;77;100;23;77;1189;541
464;08.11.2019;25;50;25;50;2543;3718
465;19.01.2020;97;121;24;80;2757;3450
466;25.08.2019;61;69;8;88;1535;721
467;17.05.2019;95;101;6;94;3176;4463
468;27.05.2019;49;54;5;90;3900;1669
469;25.03.2020;43;48;5;89;4185;2371
470;03.06.2019;9;23;14;39;278;1692
471;13.04.2019;90;129;39;69;2294;2362
472;19.11.2019;96;128;32;75;3417;1506
473;25.07.2019;77;107;30;71;2593;28
474;22.11.2019;64;96;32;66;1030;1449
475;31.05.2019;9;14;5;64;1283;2152
476;20.09.2019;99;128;29;77;1753;980
477;24.06.2019;100;108;8;92;2926;1502
478;20.06.2019;43;74;31;58;1954;647
479;08.04.2019;67;92;25;72;423;3442
480;24.04.2019;20;46;26;43;2891;1510
481;13.10.2019;8;19;11;42;82;3601
482;11.01.2020;89;121;32;73;1251;625
483;19.11.2019;72;106;34;67;3136;477
484;09.02.2020;70;78;8;89;515;1994
485;09.05.2019;73;107;34;68;4610;2797
486;26.02.2020;81;107;26;75;2415;242
487;06.06.2019;88;116;28;75;1879;326
488;05.12.2019;16;33;17;48;4191;2359
489;23.04.2019;8;32;24;25;3328;1536
490;07.02.2020;72;78;6;92;2554;794
491;25.05.2019;62;68;6;91;3040;1181
492;27.01.2020;86;124;38;69;246;846
493;12.10.2019;26;66;40;39;4155;4466
494;21.11.2019;72;80;8;90;1923;4616
495;25.05.2019;96;106;10;90;2221;4822
496;17.04.2019;49;74;25;66;2568;3922
497;30.12.2019;70;98;28;71;3607;2445
498;14.07.2019;73;111;38;65;2989;4266
499;14.02.2020;94;103;9;91;3700;1595
500;29.04.2019;68;103;35;66;2494;3806
501;09.04.2019;83;89;6;93;3732;4215
502;31.07.2019;20;36;16;55;1436;249
503;27.03.2020;84;89;5;94;4601;313
504;23.11.2019;45;84;39;53;4582;3869
505;03.09.2019;14;46;32;30;3015;3249
506;21.01.2020;87;125;38;69;4549;3238
507;19.03.2020;78;117;39;66;1904;4684
508;15.09.2019;73;84;11;86;4036;2061
509;28.10.2019;51;67;16;76;344;3496
510;27.08.2019;72;112;40;64;2245;2979
511;13.11.2019;17;51;34;33;117;954
512;06.02.2020;41;69;28;59;524;2972
513;01.07.2019;57;92;35;61;4809;4806
514;19.06.2019;20;22;2;90;3657;687
515;30.10.2019;31;36;5;86;4825;3768
516;23.03.2020;51;73;22;69;1940;4344
517;06.11.2019;33;67;34;49;727;919
518;26.04.2019;61;70;9;87;1210;983
519;07.08.2019;16;18;2;88;884;2720
520;13.05.2019;27;29;2;93;2489;2667
521;14.06.2019;3;5;2;60;2666;1611
522;15.10.2019;7;32;25;21;3902;1929
523;10.07.2019;89;96;7;92;4739;3199
524;02.11.2019;52;77;25;67;825;4839
525;24.01.2020;11;36;25;30;118;4481
526;17.10.2019;26;31;5;83;2114;341
527;02.02.2020;54;78;24;69;2457;1180
528;31.08.2019;7;12;5;58;3964;3737
529;11.08.2019;23;60;37;38;2914;242
530;24.05.2019;62;100;38;62;963;1816
531;06.08.2019;44;67;23;65;2806;502
532;07.09.2019;49;70;21;70;4570;1241
533;19.12.2019;38;58;20;65;1747;2967
534;09.12.2019;32;66;34;48;3755;3946
535;14.06.2019;76;99;23;76;868;4643
536;13.06.2019;98;112;14;87;2006;2492
537;21.07.2019;67;75;8;89;429;1348
538;20.07.2019;97;105;8;92;2166;1267
539;05.09.2019;73;89;16;82;2057;1134
540;05.03.2020;32;66;34;48;2815;1296
541;21.08.2019;86;117;31;73;4952;928
542;21.04.2019;44;80;36;55;1739;102
543;08.06.2019;96;122;26;78;3492;1942
544;10.08.2019;80;116;36;68;2035;2553
545;17.12.2019;70;77;7;90;3679;4906
546;26.07.2019;16;19;3;84;1542;2694
547;06.04.2019;50;63;13;79;258;2836
548;28.06.2019;53;89;36;59;4298;2208
549;14.12.2019;5;28;23;17;408;2713
550;10.12.2019;5;38;33;13;1463;2542
551;03.07.2019;50;89;39;56;4235;668
552;02.12.2019;60;70;10;85;3007;974
553;06.10.2019;77;81;4;95;1233;3372
554;18.07.2019;83;96;13;86;3336;4152
555;28.07.2019;28;36;8;77;679;3867
556;29.08.2019;7;26;19;26;4533;2246
557;25.08.2019;18;32;14;56;2070;1333
558;21.02.2020;25;35;10;71;4617;3020
559;18.03.2020;11;44;33;25;3837;2364
560;21.11.2019;72;94;22;76;601;3581
561;17.01.2020;40;51;11;78;4323;694
562;08.02.2020;62;90;28;68;1804;3078
563;16.02.2020;6;42;36;14;1673;168
564;02.02.2020;37;63;26;58;3801;4030
565;03.10.2019;89;129;40;68;4668;951
566;11.04.2019;14;42;28;33;1813;322
567;16.01.2020;79;115;36;68;2799;3137
568;16.06.2019;86;89;3;96;21;3921
569;22.05.2019;90;118;28;76;2720;2837
570;05.10.2019;65;76;11;85;2953;3790
571;09.05.2019;28;52;24;53;3946;4583
572;02.11.2019;13;30;17;43;2059;4719
573;30.09.2019;52;76;24;68;2637;2368
574;19.09.2019;44;69;25;63;1301;4275
575;16.01.2020;67;68;1;98;193;2601
576;21.08.2019;6;31;25;19;3272;3914
577;15.05.2019;87;92;5;94;4319;223
578;03.08.2019;96;108;12;88;4088;2193
579;23.10.2019;11;50;39;22;2408;4851
580;23.08.2019;43;48;5;89;1998;4850
581;18.06.2019;9;32;23;28;1569;3465
582;02.05.2019;42;79;37;53;1674;4869
583;24.01.2020;20;35;15;57;3159;1784
584;12.08.2019;56;77;21;72;1519;2117
585;31.08.2019;1;18;17;5;2573;1731
586;28.10.2019;70;79;9;88;2841;2692
587;08.04.2019;62;65;3;95;1411;3705
588;11.09.2019;97;119;22;81;2913;2366
589;21.05.2019;93;110;17;84;4109;4148
590;02.10.2019;99;117;18;84;731;563
591;02.11.2019;31;63;32;49;514;2068
592;16.04.2019;42;69;27;60;2318;3975
593;01.05.2019;47;69;22;68;3095;111
594;11.02.2020;87;90;3;96;482;1674
595;18.03.2020;8;17;9;47;1187;2235
596;09.01.2020;52;56;4;92;4556;3620
597;07.06.2019;58;93;35;62;1599;4714
598;16.06.2019;33;64;31;51;2293;1533
599;26.09.2019;14;20;6;70;2062;1217
600;30.08.2019;74;98;24;75;2173;1827
601;21.08.2019;18;46;28;39;33;1772
602;08.07.2019;70;107;37;65;1633;2349
603;11.01.2020;65;90;25;72;22;1459
604;08.10.2019;35;60;25;58;1607;1336
605;12.09.2019;61;64;3;95;2725;1124
606;11.06.2019;83;92;9;90;2398;2845
607;04.11.2019;38;72;34;52;54;715
608;29.05.2019;78;94;16;82;167;1222
609;12.11.2019;73;79;6;92;3715;705
610;14.06.2019;76;79;3;96;3948;2264
611;03.11.2019;90;124;34;72;1659;3182
612;28.11.2019;12;47;35;25;3088;1132
613;02.11.2019;49;55;6;89;1864;2535
614;13.09.2019;20;33;13;60;4838;2179
615;10.05.2019;40;79;39;50;2710;2303
616;30.11.2019;48;79;31;60;941;1711
617;04.05.2019;35;64;29;54;2598;4296
618;29.01.2020;97;122;25;79;1463;4709
619;11.01.2020;93;99;6;93;3900;493
620;23.02.2020;30;37;7;81;2654;4553
621;06.08.2019;14;39;25;35;2244;2313
622;24.07.2019;75;111;36;67;3246;1889
623;31.03.2019;87;115;28;75;978;3286
624;06.12.2019;70;101;31;69;522;3745
625;11.05.2019;86;91;5;94;1716;2270
626;16.08.2019;94;108;14;87;3;428
627;06.10.2019;53;92;39;57;1038;2639
628;30.06.2019;83;114;31;72;2041;1059
629;27.02.2020;79;80;1;98;1093;3573
630;21.08.2019;75;79;4;94;166;3441
631;29.06.2019;53;64;11;82;2244;933
632;28.02.2020;52;63;11;82;1995;2198
633;03.06.2019;71;108;37;65;2778;2940
634;28.08.2019;28;57;29;49;150;4087
635;20.06.2019;49;80;31;61;875;46
636;31.01.2020;6;31;25;19;810;200
637;27.03.2020;29;42;13;69;4736;2162
638;02.01.2020;100;105;5;95;2853;4971
639;20.11.2019;63;74;11;85;3909;4914
640;28.06.2019;87;106;19;82;1502;4958
641;14.11.2019;51;69;18;73;220;1773
642;12.02.2020;86;112;26;76;4271;4941
643;16.05.2019;24;28;4;85;474;4829
644;20.09.2019;46;48;2;95;3374;998
645;10.06.2019;27;67;40;40;4091;2096
646;12.02.2020;31;71;40;43;2135;2796
647;17.04.2019;86;107;21;80;1257;1805
648;25.10.2019;2;33;31;6;2966;2656
649;02.05.2019;28;60;32;46;2359;3755
650;22.03.2020;37;67;30;55;1032;4745
651;21.02.2020;55;69;14;79;4164;385
652;05.01.2020;59;66;7;89;2541;1009
653;22.01.2020;61;62;1;98;4397;1681
654;04.05.2019;1;7;6;14;4002;3706
655;18.03.2020;55;70;15;78;2937;2686
656;16.09.2019;38;43;5;88;2968;3491
657;02.02.2020;92;130;38;70;2108;2565
658;04.10.2019;95;101;6;94;969;2269
659;15.09.2019;40;69;29;57;2911;1404
660;09.01.2020;97;122;25;79;167;3647
661;08.11.2019;79;95;16;83;1102;1580
662;02.10.2019;36;69;33;52;2474;751
663;21.08.2019;25;36;11;69;2046;1749
664;22.07.2019;1;23;22;4;2242;2945
665;01.03.2020;69;76;7;90;1565;1608
666;02.11.2019;92;94;2;97;1410;4814
667;06.01.2020;30;66;36;45;1478;666
668;10.07.2019;61;63;2;96;4830;3626
669;22.04.2019;8;27;19;29;1223;1572
670;12.06.2019;29;61;32;47;2315;105
671;12.07.2019;25;49;24;51;307;2154
672;15.04.2019;68;96;28;70;2370;2290
673;27.04.2019;32;55;23;58;3793;2781
674;22.04.2019;72;110;38;65;4063;2031
675;15.02.2020;20;40;20;50;3403;4965
676;10.09.2019;34;68;34;50;4274;4052
677;09.11.2019;3;13;10;23;4072;4224
678;31.05.2019;26;37;11;70;2253;204
679;28.07.2019;68;95;27;71;4576;2205
680;12.12.2019;14;37;23;37;3307;3324
681;29.06.2019;65;80;15;81;1048;433
682;09.01.2020;47;84;37;55;3320;4306
683;22.03.2020;30;32;2;93;3163;1038
684;12.11.2019;79;81;2;97;159;3473
685;05.06.2019;49;69;20;71;4467;2741
686;17.09.2019;16;30;14;53;1019;4766
687;11.09.2019;49;59;10;83;360;3274
688;10.04.2019;92;99;7;92;2506;4077
689;09.01.2020;83;104;21;79;1521;1291
690;18.01.2020;85;93;8;91;3548;3206
691;30.03.2019;62;65;3;95;4597;1193
692;16.09.2019;63;93;30;67;2272;889
693;24.04.2019;86;105;19;81;2908;2003
694;01.02.2020;45;85;40;52;4825;4564
695;11.11.2019;23;32;9;71;3054;3728
696;05.01.2020;85;106;21;80;4926;29
697;07.05.2019;28;46;18;60;3283;2298
698;18.11.2019;71;81;10;87;3610;3193
699;03.11.2019;25;39;14;64;1830;1923
700;28.02.2020;70;97;27;72;3142;4911
701;04.04.2019;6;7;1;85;4205;4120
702;09.11.2019;7;24;17;29;4301;1010
703;25.08.2019;20;58;38;34;3915;2147
704;27.09.2019;57;76;19;75;3908;2314
705;24.11.2019;64;78;14;82;4128;2907
706;16.09.2019;3;5;2;60;2010;2338
707;14.10.2019;32;56;24;57;4921;1393
708;30.04.2019;98;99;1;98;3582;2516
709;08.05.2019;78;114;36;68;4554;1301
710;22.03.2020;2;27;25;7;38;3504
711;07.09.2019;9;17;8;52;474;3376
712;23.11.2019;27;52;25;51;4423;1926
713;30.10.2019;52;68;16;76;3080;1446
714;21.05.2019;3;24;21;12;4035;3405
715;16.11.2019;36;53;17;67;4864;3639
716;04.03.2020;48;52;4;92;1892;1985
717;08.10.2019;93;96;3;96;4332;3131
718;10.05.2019;47;52;5;90;2636;4324
719;12.07.2019;56;85;29;65;514;1657
720;03.10.2019;81;121;40;66;771;2938
721;21.05.2019;43;68;25;63;1257;2744
722;30.03.2019;95;126;31;75;4645;1000
723;16.05.2019;37;69;32;53;2976;4613
724;22.12.2019;9;36;27;25;4720;265
725;24.10.2019;74;113;39;65;4318;4370
726;13.08.2019;49;56;7;87;1565;661
727;29.03.2019;23;31;8;74;4742;2382
728;19.10.2019;48;69;21;69;769;3037
729;11.07.2019;34;60;26;56;4135;211
730;16.03.2020;55;76;21;72;2943;1701
731;12.09.2019;22;60;38;36;3861;1011
732;15.08.2019;45;77;32;58;4549;2601
733;29.05.2019;46;72;26;63;4475;4874
734;26.10.2019;14;50;36;28;4498;3183
735;21.02.2020;53;60;7;88;517;120
736;23.04.2019;22;42;20;52;3642;3002
737;05.05.2019;46;61;15;75;1429;2466
738;19.12.2019;63;96;33;65;2781;1238
739;29.09.2019;48;71;23;67;1885;3324
740;27.11.2019;36;65;29;55;925;3269
741;26.12.2019;41;59;18;69;939;283
742;07.01.2020;84;107;23;78;452;1473
743;19.11.2019;67;69;2;97;2655;299
744;10.03.2020;83;104;21;79;810;133
745;18.03.2020;55;92;37;59;1730;3911
746;13.04.2019;75;108;33;69;3150;1397
747;16.10.2019;63;93;30;67;3172;2221
748;09.12.2019;69;107;38;64;2186;4305
749;01.08.2019;1;3;2;33;1184;1160
750;18.12.2019;53;66;13;80;4358;2605
751;06.11.2019;84;86;2;97;1786;4966
752;29.10.2019;13;40;27;32;3144;2973
753;20.08.2019;100;107;7;93;3595;3603
754;24.06.2019;98;133;35;73;2459;3922
755;15.09.2019;7;20;13;35;3825;84
756;11.05.2019;87;116;29;75;2195;1854
757;10.04.2019;71;75;4;94;3898;36
758;18.08.2019;31;42;11;73;3942;979
759;29.09.2019;50;55;5;90;697;4293
760;29.09.2019;49;80;31;61;590;4819
761;08.01.2020;87;127;40;68;3577;3382
762;21.04.2019;99;115;16;86;4425;1481
763;18.10.2019;28;35;7;80;1293;1878
764;23.08.2019;42;77;35;54;4855;4529
765;26.03.2020;42;60;18;70;3683;4563
766;07.11.2019;1;39;38;2;466;130
767;24.02.2020;47;72;25;65;1461;4096
768;11.04.2019;38;47;9;80;1731;4811
769;30.03.2019;35;44;9;79;694;2626
770;17.05.2019;63;85;22;74;1980;2508
771;14.09.2019;19;38;19;50;2987;1824
772;13.05.2019;36;42;6;85;509;4189
773;31.10.2019;74;87;13;85;929;926
774;13.08.2019;54;90;36;60;4922;3059
775;29.07.2019;59;95;36;62;1793;4090
776;24.06.2019;55;79;24;69;4641;2880
777;11.10.2019;4;14;10;28;2648;3168
778;13.12.2019;35;71;36;49;4501;1162
779;09.05.2019;48;84;36;57;3806;952
780;24.03.2020;30;37;7;81;2736;1448
781;18.10.2019;92;125;33;73;3026;3617
782;15.04.2019;95;120;25;79;1943;4502
783;12.11.2019;15;45;30;33;1515;4229
784;14.12.2019;8;36;28;22;2386;4651
785;05.08.2019;63;78;15;80;812;3167
786;05.01.2020;53;56;3;94;4785;315
787;24.04.2019;80;116;36;68;1330;1105
788;12.06.2019;27;39;12;69;4735;313
789;20.10.2019;16;44;28;36;3463;1383
790;11.02.2020;64;76;12;84;1048;375
791;04.05.2019;92;100;8;92;4491;4597
792;29.02.2020;56;89;33;62;4551;30
793;29.05.2019;32;50;18;64;1111;1739
794;02.03.2020;54;84;30;64;1032;4400
795;13.02.2020;90;100;10;90;910;253
796;02.12.2019;72;109;37;66;2435;3555
797;31.07.2019;74;92;18;80;2719;2976
798;15.10.2019;78;104;26;75;2072;2460
799;17.05.2019;15;47;32;31;182;299
800;18.10.2019;74;94;20;78;745;4430
801;14.05.2019;2;31;29;6;1725;129
802;27.01.2020;98;111;13;88;4027;3657
803;11.01.2020;42;76;34;55;1775;821
804;14.02.2020;9;35;26;25;3387;3095
805;08.12.2019;19;26;7;73;154;3350
806;10.08.2019;74;93;19;79;1529;2158
807;28.09.2019;1;30;29;3;4837;4763
808;25.06.2019;56;86;30;65;1871;563
809;13.03.2020;1;33;32;3;3680;1390
810;07.11.2019;40;71;31;56;2064;4219
811;02.07.2019;23;42;19;54;4222;537
812;05.08.2019;39;50;11;78;2025;1999
813;13.07.2019;92;110;18;83;2016;540
814;12.03.2020;31;49;18;63;1602;923
815;05.07.2019;67;82;15;81;1598;4381
816;29.10.2019;97;109;12;88;2047;4252
817;15.04.2019;52;82;30;63;4759;443
818;19.07.2019;22;57;35;38;3718;1815
819;08.09.2019;42;73;31;57;1780;3763
820;21.12.2019;30;43;13;69;98;4103
821;06.06.2019;55;72;17;76;1236;2093
822;16.04.2019;36;38;2;94;3381;977
823;16.10.2019;31;64;33;48;4569;2976
824;23.07.2019;80;120;40;66;3939;4885
825;30.12.2019;20;25;5;80;3811;1591
826;23.05.2019;77;95;18;81;796;3949
827;19.06.2019;88;117;29;75;4246;85
828;12.02.2020;26;49;23;53;1661;781
829;13.12.2019;7;13;6;53;2479;938
830;14.11.2019;66;103;37;64;1322;436
831;10.05.2019;2;14;12;14;543;4920
832;01.06.2019;54;67;13;80;1269;2816
833;07.09.2019;7;22;15;31;1785;4094
834;12.07.2019;71;86;15;82;4409;2938
835;16.02.2020;77;88;11;87;2697;3519
836;15.07.2019;73;104;31;70;286;3203
837;13.04.2019;23;50;27;46;2201;2196
838;02.08.2019;51;69;18;73;2126;2121
839;26.12.2019;88;113;25;77;567;3889
840;23.04.2019;74;83;9;89;3350;3509
841;23.01.2020;26;43;17;60;2857;680
842;08.10.2019;88;127;39;69;4107;2821
843;15.07.2019;79;104;25;75;202;2685
844;15.07.2019;31;48;17;64;3864;3801
845;22.12.2019;77;82;5;93;3962;4746
846;09.01.2020;87;91;4;95;2270;2131
847;19.06.2019;17;54;37;31;3219;3501
848;27.03.2020;65;102;37;63;3088;3138
849;22.01.2020;22;56;34;39;4386;4140
850;11.12.2019;16;37;21;43;1999;4464
851;04.06.2019;44;75;31;58;2156;562
852;30.12.2019;68;74;6;91;760;4925
853;29.01.2020;15;26;11;57;4789;2996
854;24.06.2019;20;23;3;86;1985;2916
855;04.06.2019;77;87;10;88;2093;4325
856;24.10.2019;83;112;29;74;2414;243
857;24.10.2019;37;77;40;48;4493;1493
858;28.12.2019;45;80;35;56;2257;2482
859;09.08.2019;68;83;15;81;3947;2095
860;09.06.2019;24;27;3;88;4344;1121
861;02.05.2019;85;93;8;91;1915;2996
862;24.12.2019;34;46;12;73;4415;2980
863;27.04.2019;65;78;13;83;4420;2097
864;11.06.2019;87;97;10;89;689;2817
865;16.03.2020;99;134;35;73;3375;3647
866;14.08.2019;15;28;13;53;4162;149
867;13.06.2019;56;67;11;83;4817;1031
868;23.08.2019;78;96;18;81;2102;461
869;15.09.2019;76;105;29;72;3414;4760
870;12.07.2019;20;45;25;44;3572;1838
871;01.10.2019;2;19;17;10;3732;2070
872;31.01.2020;59;72;13;81;4225;664
873;05.09.2019;95;97;2;97;1164;684
874;19.06.2019;53;56;3;94;3581;4764
875;27.08.2019;94;129;35;72;3627;3490
876;23.08.2019;78;104;26;75;4341;759
877;03.07.2019;41;72;31;56;2389;2716
878;19.04.2019;94;112;18;83;2046;4014
879;21.05.2019;96;110;14;87;2476;4835
880;25.01.2020;76;115;39;66;4418;2019
881;06.09.2019;15;29;14;51;1940;4281
882;27.03.2020;81;105;24;77;4257;3205
883;22.03.2020;29;39;10;74;4641;3890
884;29.05.2019;85;88;3;96;3068;523
885;10.09.2019;80;106;26;75;1229;3222
886;20.02.2020;90;129;39;69;3659;3279
887;17.12.2019;16;53;37;30;1711;2103
888;05.07.2019;28;63;35;44;2623;2569
889;13.12.2019;66;85;19;77;2833;2899
890;29.07.2019;30;60;30;50;1053;2570
891;13.07.2019;15;24;9;62;3063;3528
892;06.05.2019;59;82;23;71;3327;2098
893;19.07.2019;21;59;38;35;2867;3890
894;27.11.2019;48;55;7;87;4477;1343
895;31.03.2019;30;61;31;49;4523;4859
896;28.11.2019;100;121;21;82;3441;4332
897;03.04.2019;39;41;2;95;4974;862
898;01.06.2019;78;87;9;89;4096;3247
899;21.12.2019;64;73;9;87;1984;4449
900;19.07.2019;51;64;13;79;3459;100
901;23.06.2019;83;98;15;84;3140;3421
902;18.06.2019;29;54;25;53;1456;3839
903;08.05.2019;92;114;22;80;3571;2880
904;13.06.2019;57;88;31;64;1078;3220
905;25.04.2019;98;103;5;95;4501;3378
906;29.04.2019;18;56;38;32;3149;1245
907;09.10.2019;66;96;30;68;3221;928
908;14.10.2019;54;60;6;90;1010;1405
909;01.05.2019;33;65;32;50;938;1376
910;03.06.2019;6;38;32;15;4193;3004
911;07.03.2020;91;129;38;70;2709;4419
912;02.12.2019;62;64;2;96;3194;3818
913;20.09.2019;3;21;18;14;1049;205
914;06.07.2019;73;109;36;66;3250;4893
915;05.01.2020;17;37;20;45;3035;4992
916;25.10.2019;14;33;19;42;4865;1502
917;09.04.2019;85;89;4;95;1177;583
918;29.06.2019;67;83;16;80;807;4497
919;16.09.2019;99;101;2;98;3066;2549
920;29.04.2019;55;94;39;58;871;960
921;04.10.2019;65;76;11;85;1771;4330
922;26.11.2019;2;9;7;22;919;4309
923;04.03.2020;61;77;16;79;323;3717
924;08.10.2019;41;52;11;78;1144;3770
925;05.10.2019;12;29;17;41;490;4068
926;30.07.2019;52;84;32;61;709;692
927;27.02.2020;38;75;37;50;519;83
928;14.01.2020;10;33;23;30;957;3543
929;20.12.2019;46;63;17;73;1199;1738
930;17.02.2020;30;67;37;44;4235;4126
931;19.08.2019;71;80;9;88;1026;1648
932;11.04.2019;18;43;25;41;2597;4491
933;20.04.2019;56;94;38;59;3537;2324
934;01.07.2019;1;23;22;4;813;1322
935;15.11.2019;65;80;15;81;1686;4639
936;22.03.2020;4;24;20;16;4560;2936
937;29.02.2020;29;35;6;82;2965;2768
938;21.09.2019;98;123;25;79;2149;3100
939;30.03.2019;28;44;16;63;3523;4062
940;08.06.2019;66;82;16;80;1459;4370
941;09.10.2019;21;51;30;41;2956;4414
942;15.12.2019;44;53;9;83;3980;2146
943;13.09.2019;5;24;19;20;4880;2589
944;22.04.2019;63;79;16;79;4607;947
945;11.10.2019;40;56;16;71;3201;1948
946;28.07.2019;96;135;39;71;4620;2802
947;02.03.2020;87;90;3;96;2701;16
948;02.10.2019;50;61;11;81;4844;2186
949;19.06.2019;66;102;36;64;1585;480
950;13.10.2019;61;67;6;91;1876;3037
951;24.12.2019;55;92;37;59;167;2099
952;20.03.2020;78;86;8;90;4294;1577
953;25.05.2019;95;131;36;72;4623;385
954;10.01.2020;50;74;24;67;4061;789
955;07.06.2019;73;108;35;67;2713;1637
956;14.04.2019;26;32;6;81;3062;3172
957;24.03.2020;32;55;23;58;3652;4354
958;01.07.2019;45;60;15;75;2821;3869
959;05.03.2020;44;75;31;58;4973;2516
960;02.12.2019;89;115;26;77;418;960
961;08.10.2019;23;50;27;46;4215;4959
962;23.08.2019;86;89;3;96;1009;1519
963;20.11.2019;50;54;4;92;3815;3182
964;05.10.2019;26;31;5;83;875;188
965;04.10.2019;55;76;21;72;712;1642
966;22.09.2019;54;87;33;62;2115;2813
967;06.04.2019;50;86;36;58;4559;1055
968;27.05.2019;72;105;33;68;2845;1389
969;07.06.2019;9;36;27;25;2170;3002
970;19.06.2019;54;55;1;98;204;4625
971;30.04.2019;20;44;24;45;3679;4476
972;18.11.2019;48;80;32;60;2870;1509
973;17.12.2019;96;99;3;96;253;2857
974;01.03.2020;75;111;36;67;1673;2405
975;08.03.2020;23;47;24;48;2930;3800
976;18.03.2020;72;93;21;77;2974;501
977;03.03.2020;63;90;27;70;3398;3334
978;07.01.2020;43;46;3;93;4908;853
979;04.11.2019;74;100;26;74;3656;617
980;09.02.2020;9;33;24;27;4651;427
981;07.02.2020;37;73;36;50;3010;2972
982;18.07.2019;19;39;20;48;3286;2802
983;12.08.2019;91;96;5;94;1866;503
984;07.08.2019;79;83;4;95;4549;4896
985;21.03.2020;22;27;5;81;555;1512
986;27.05.2019;70;108;38;64;2028;804
987;30.11.2019;21;42;21;50;2455;2813
988;20.02.2020;14;17;3;82;140;1309
989;25.06.2019;33;73;40;45;460;193
990;24.11.2019;10;48;38;20;1026;4709
991;26.06.2019;26;32;6;81;1278;3298
992;22.05.2019;27;64;37;42;1788;928
993;03.02.2020;26;34;8;76;3167;3555
994;25.09.2019;32;63;31;50;1735;2006
995;17.12.2019;80;86;6;93;2019;465
996;22.10.2019;90;119;29;75;4891;832
997;14.06.2019;49;71;22;69;142;2337
998;07.02.2020;74;94;20;78;3659;2182
999;22.01.2020;96;107;11;89;3132;4559
1000;15.12.2019;21;30;9;70;888;4250
1001;08.05.2019;62;92;30;67;309;97
1002;01.11.2019;15;45;30;33;3182;1267
1003;19.10.2019;76;103;27;73;2468;3609
1004;08.04.2019;9;18;9;50;2115;3543
1005;17.12.2019;9;40;31;22;4902;1286
1006;24.12.2019;71;74;3;95;4185;3049
1007;17.01.2020;26;27;1;96;2270;826
1008;26.10.2019;90;124;34;72;3262;3265
1009;07.12.2019;89;122;33;72;2813;4575
1010;30.10.2019;3;11;8;27;4439;3078
1011;02.03.2020;29;33;4;87;355;4191
1012;15.04.2019;51;80;29;63;4845;2240
1013;26.05.2019;51;84;33;60;4258;4930
1014;04.08.2019;92;96;4;95;495;4340
1015;23.04.2019;12;22;10;54;4362;476
1016;07.03.2020;100;111;11;90;2078;4157
1017;24.01.2020;43;47;4;91;1004;1525
1018;25.05.2019;70;90;20;77;989;2424
1019;23.04.2019;70;100;30;70;4297;503
1020;02.12.2019;87;127;40;68;832;378
1021;02.08.2019;48;83;35;57;2272;1242
1022;07.09.2019;8;33;25;24;4490;1686
1023;20.10.2019;15;53;38;28;4648;458
1024;08.04.2019;44;68;24;64;3994;4714
1025;07.02.2020;75;112;37;66;2917;2666
1026;17.02.2020;78;90;12;86;328;4210
1027;04.12.2019;83;91;8;91;1057;3091
1028;26.03.2020;20;59;39;33;2785;1221
1029;23.01.2020;77;111;34;69;3153;1724
1030;28.07.2019;19;44;25;43;2296;3697
1031;20.08.2019;44;60;16;73;1671;736
1032;29.05.2019;48;75;27;64;1564;3129
1033;26.10.2019;64;89;25;71;1007;1626
1034;15.08.2019;35;40;5;87;4789;4968
1035;18.12.2019;1;22;21;4;4502;2938
1036;03.06.2019;87;124;37;70;2309;1710
1037;05.01.2020;73;78;5;93;4915;4851
1038;31.05.2019;37;41;4;90;1426;2007
1039;07.10.2019;65;83;18;78;294;1868
1040;22.06.2019;73;83;10;87;4259;4903
1041;18.02.2020;57;75;18;76;3293;1318
1042;07.01.2020;19;37;18;51;4253;2176
1043;23.05.2019;75;83;8;90;2357;4729
1044;24.12.2019;61;96;35;63;3024;4995
1045;09.06.2019;99;128;29;77;3985;955
1046;28.06.2019;31;70;39;44;2989;2771
1047;11.05.2019;15;30;15;50;2237;2764
1048;10.01.2020;59;89;30;66;1788;1785
1049;06.01.2020;16;44;28;36;4407;638
1050;02.04.2019;59;82;23;71;3079;4031
1051;15.09.2019;36;61;25;59;2423;238
1052;22.10.2019;22;55;33;40;4731;607
1053;11.12.2019;75;81;6;92;2544;4937
1054;04.06.2019;10;48;38;20;1007;4203
1055;11.01.2020;31;45;14;68;173;4556
1056;01.05.2019;35;57;22;61;251;3027
1057;30.10.2019;38;57;19;66;4891;4527
1058;31.12.2019;74;87;13;85;777;902
1059;18.11.2019;1;41;40;2;19;569
1060;09.06.2019;42;72;30;58;492;3294
1061;04.05.2019;57;77;20;74;599;4596
1062;12.03.2020;20;48;28;41;959;4984
1063;15.09.2019;87;117;30;74;3935;2299
1064;29.02.2020;66;84;18;78;3429;1725
1065;25.07.2019;1;38;37;2;3021;4274
1066;03.05.2019;76;108;32;70;3441;4029
1067;13.07.2019;87;94;7;92;4179;399
1068;26.03.2020;45;73;28;61;2600;4000
1069;03.08.2019;49;86;37;56;2736;4077
1070;18.05.2019;49;69;20;71;2806;1665
1071;16.09.2019;99;126;27;78;751;2516
1072;28.09.2019;3;42;39;7;2402;2170
1073;18.05.2019;93;132;39;70;3203;642
1074;21.02.2020;40;43;3;93;2198;1032
1075;10.09.2019;78;90;12;86;1984;3022
1076;02.09.2019;18;53;35;33;441;3632
1077;20.01.2020;38;41;3;92;4891;3693
1078;20.12.2019;2;3;1;66;3630;2479
1079;17.05.2019;34;51;17;66;1015;2175
1080;09.10.2019;72;91;19;79;2069;3972
1081;08.02.2020;34;70;36;48;215;4901
1082;08.05.2019;26;32;6;81;4350;3457
1083;18.03.2020;90;93;3;96;4358;4601
1084;28.01.2020;77;88;11;87;3939;1917
1085;30.04.2019;17;57;40;29;86;3649
1086;14.07.2019;7;18;11;38;1439;4675
1087;02.01.2020;30;34;4;88;496;139
1088;11.03.2020;95;123;28;77;882;3580
1089;10.03.2020;75;78;3;96;2331;3680
1090;29.03.2019;77;78;1;98;4954;2960
1091;25.09.2019;78;98;20;79;1546;1008
1092;08.08.2019;11;47;36;23;4114;3758
1093;05.05.2019;46;59;13;77;4425;4432
1094;11.12.2019;71;100;29;71;24;4786
1095;10.05.2019;12;20;8;60;1061;3456
1096;01.02.2020;56;79;23;70;1658;1730
1097;13.11.2019;42;57;15;73;998;4695
1098;16.12.2019;57;75;18;76;2589;3710
1099;24.03.2020;34;67;33;50;634;3414
1100;06.01.2020;2;8;6;25;2275;2390
1101;11.08.2019;58;66;8;87;1130;1688
1102;01.11.2019;24;26;2;92;1714;485
1103;22.07.2019;100;125;25;80;3318;1177
1104;13.06.2019;46;70;24;65;2834;1375
1105;31.03.2019;52;83;31;62;238;54
1106;19.09.2019;94;126;32;74;4522;970
1107;15.10.2019;50;86;36;58;4845;2098
1108;26.11.2019;91;104;13;87;1196;2864
1109;20.03.2020;18;49;31;36;2128;4748
1110;19.08.2019;32;51;19;62;2386;1409
1111;29.05.2019;5;42;37;11;4843;4450
1112;07.11.2019;82;117;35;70;725;4831
1113;24.09.2019;65;84;19;77;3206;1984
1114;29.02.2020;94;123;29;76;3291;3026
1115;04.02.2020;61;94;33;64;4657;4457
1116;17.05.2019;68;71;3;95;4820;1448
1117;23.11.2019;9;39;30;23;1835;4276
1118;25.10.2019;9;34;25;26;4291;975
1119;02.05.2019;3;15;12;20;1985;2454
1120;17.12.2019;66;79;13;83;4319;1574
1121;27.10.2019;100;123;23;81;801;974
1122;12.10.2019;55;77;22;71;3352;2976
1123;04.04.2019;44;50;6;88;2183;3264
1124;06.05.2019;42;55;13;76;231;3941
1125;05.03.2020;19;47;28;40;3317;963
1126;08.09.2019;46;83;37;55;805;1469
1127;08.02.2020;61;78;17;78;746;4920
1128;11.08.2019;40;55;15;72;1697;893
1129;05.02.2020;16;22;6;72;2385;957
1130;29.08.2019;11;42;31;26;77;3289
1131;01.02.2020;90;108;18;83;667;4071
1132;05.05.2019;33;51;18;64;1664;4623
1133;02.11.2019;16;30;14;53;51;2146
1134;31.03.2019;2;25;23;8;2676;679
1135;04.07.2019;67;101;34;66;3088;3009
1136;07.02.2020;35;52;17;67;598;2625
1137;18.01.2020;68;90;22;75;2807;1282
1138;29.06.2019;70;103;33;67;3257;4611
1139;12.04.2019;80;115;35;69;1200;24
1140;18.01.2020;35;39;4;89;4825;3642
1141;05.02.2020;19;47;28;40;1793;4230
1142;06.02.2020;45;73;28;61;3034;1436
1143;21.04.2019;67;87;20;77;3543;1230
1144;02.12.2019;52;57;5;91;3351;4472
1145;23.04.2019;23;28;5;82;197;1783
1146;15.09.2019;35;48;13;72;790;1369
1147;27.11.2019;67;70;3;95;1216;4537
1148;18.07.2019;98;103;5;95;4437;3756
1149;06.12.2019;49;54;5;90;4639;3410
1150;22.12.2019;60;79;19;75;340;4199
1151;25.09.2019;38;49;11;77;1170;1846
1152;20.05.2019;7;38;31;18;2091;3939
1153;20.07.2019;32;53;21;60;4492;4219
1154;29.08.2019;39;45;6;86;518;2373
1155;24.08.2019;65;92;27;70;2768;1953
1156;15.11.2019;7;33;26;21;927;4405
1157;29.06.2019;5;31;26;16;4652;3873
1158;15.06.2019;67;97;30;69;1175;1939
1159;24.10.2019;28;61;33;45;2613;946
1160;27.08.2019;87;122;35;71;1087;26
1161;03.07.2019;43;69;26;62;1376;743
1162;28.06.2019;53;88;35;60;36;4568
1163;22.06.2019;50;68;18;73;1948;989
1164;19.01.2020;32;57;25;56;384;895
1165;18.12.2019;62;78;16;79;4404;2045
1166;30.12.2019;88;107;19;82;3912;4524
1167;28.02.2020;65;96;31;67;967;2578
1168;17.04.2019;30;51;21;58;4430;4813
1169;20.05.2019;72;106;34;67;2979;4853
1170;31.08.2019;60;75;15;80;3041;385
1171;03.08.2019;10;35;25;28;3631;1883
1172;07.11.2019;11;42;31;26;457;792
1173;06.04.2019;17;33;16;51;1608;1886
1174;31.12.2019;79;83;4;95;2522;4520
1175;24.07.2019;5;39;34;12;2420;2017
1176;20.02.2020;52;89;37;58;384;2089
1177;12.12.2019;48;72;24;66;1302;4210
1178;08.10.2019;80;85;5;94;800;3909
1179;05.08.2019;47;85;38;55;34;3138
1180;28.05.2019;30;48;18;62;1659;1481
1181;22.10.2019;32;58;26;55;3807;609
1182;10.09.2019;52;91;39;57;196;2645
1183;27.05.2019;43;52;9;82;671;4889
1184;27.12.2019;64;97;33;65;1732;886
1185;05.06.2019;25;54;29;46;765;2137
1186;03.12.2019;74;96;22;77;1991;2138
1187;03.06.2019;75;103;28;72;4537;961
1188;27.08.2019;90;109;19;82;2857;3438
1189;25.03.2020;47;69;22;68;1210;4627
1190;30.04.2019;70;98;28;71;434;4636
1191;26.02.2020;41;73;32;56;811;2819
1192;18.12.2019;12;24;12;50;4803;753
1193;11.01.2020;24;28;4;85;417;4036
1194;17.06.2019;9;35;26;25;2604;468
1195;06.09.2019;5;15;10;33;2712;1253
1196;14.08.2019;57;63;6;90;1078;3081
1197;10.07.2019;94;130;36;72;1141;1846
1198;02.12.2019;97;103;6;94;4654;4324
1199;19.11.2019;39;48;9;81;2312;3821
1200;14.11.2019;16;23;7;69;842;2246
1201;26.08.2019;51;71;20;71;1722;3199
1202;20.07.2019;77;105;28;73;3546;1016
1203;13.02.2020;17;19;2;89;3146;81
1204;29.03.2019;62;65;3;95;3584;536
1205;13.06.2019;57;76;19;75;4672;1740
1206;13.10.2019;89;128;39;69;4012;1561
1207;15.12.2019;17;35;18;48;1074;3598
1208;18.05.2019;29;55;26;52;2580;4332
1209;16.06.2019;50;64;14;78;1515;1502
1210;30.11.2019;83;119;36;69;4742;3028
1211;26.08.2019;4;15;11;26;2210;4516
1212;14.10.2019;67;84;17;79;2496;1702
1213;27.05.2019;21;43;22;48;1957;442
1214;11.06.2019;100;107;7;93;1556;923
1215;11.06.2019;35;57;22;61;468;3175
1216;20.07.2019;31;56;25;55;1054;3316
1217;25.12.2019;79;113;34;69;3487;4845
1218;20.08.2019;60;99;39;60;115;4560
1219;02.12.2019;74;99;25;74;4787;4992
1220;01.12.2019;19;55;36;34;3476;4251
1221;01.07.2019;63;82;19;76;2437;2283
1222;07.01.2020;63;85;22;74;4227;2045
1223;25.10.2019;70;72;2;97;4684;3425
1224;24.02.2020;96;112;16;85;1818;753
1225;27.10.2019;2;33;31;6;2667;307
1226;07.10.2019;77;103;26;74;2519;1615
1227;09.03.2020;82;85;3;96;171;4617
1228;05.06.2019;37;70;33;52;3079;455
1229;25.04.2019;53;58;5;91;2750;149
1230;16.06.2019;74;97;23;76;4653;1800
1231;18.10.2019;56;88;32;63;4874;3760
1232;25.11.2019;87;119;32;73;416;3793
1233;27.01.2020;75;114;39;65;4333;878
1234;25.11.2019;61;76;15;80;1680;3589
1235;08.10.2019;26;41;15;63;3031;4125
1236;01.02.2020;63;78;15;80;3926;4718
1237;12.07.2019;84;103;19;81;2351;883
1238;12.07.2019;16;18;2;88;4922;3592
1239;08.06.2019;46;75;29;61;2860;1437
1240;18.02.2020;28;42;14;66;2468;4849
1241;15.02.2020;38;50;12;76;156;2316
1242;28.03.2020;61;75;14;81;2945;3544
1243;09.02.2020;98;131;33;74;330;2537
1244;04.10.2019;26;32;6;81;3348;2771
1245;23.02.2020;20;30;10;66;4919;2656
1246;07.07.2019;28;33;5;84;1085;2746
1247;21.07.2019;97;131;34;74;793;3140
1248;17.07.2019;15;20;5;75;1281;1737
1249;01.12.2019;34;52;18;65;1325;2107
1250;20.04.2019;81;110;29;73;3598;4433
1251;19.02.2020;39;68;29;57;4667;1684
1252;08.04.2019;3;6;3;50;1985;50
1253;28.06.2019;43;70;27;61;2269;1378
1254;15.12.2019;65;76;11;85;1843;613
1255;07.11.2019;25;46;21;54;1497;2975
1256;11.06.2019;83;102;19;81;1816;3494
1257;16.02.2020;48;52;4;92;2284;1406
1258;20.11.2019;71;94;23;75;3587;4168
1259;16.05.2019;27;34;7;79;476;2836
1260;23.01.2020;47;50;3;94;4405;284
1261;26.01.2020;93;123;30;75;772;1961
1262;14.10.2019;75;95;20;78;2951;3109
1263;19.10.2019;19;40;21;47;3181;4558
1264;29.09.2019;72;79;7;91;660;2781
1265;20.12.2019;3;14;11;21;1575;3533
1266;14.05.2019;48;81;33;59;4348;1044
1267;18.12.2019;97;114;17;85;468;1544
1268;29.02.2020;45;78;33;57;34;3622
1269;07.08.2019;44;50;6;88;1302;4262
1270;12.04.2019;58;66;8;87;2947;2351
1271;25.12.2019;10;31;21;32;147;3410
1272;09.11.2019;15;31;16;48;916;1143
1273;28.03.2020;78;80;2;97;4882;385
1274;05.10.2019;16;53;37;30;735;1977
1275;25.08.2019;25;50;25;50;1212;4361
1276;11.10.2019;1;8;7;12;2103;3872
1277;20.03.2020;26;35;9;74;1070;1993
1278;13.11.2019;37;62;25;59;1600;763
1279;26.02.2020;52;57;5;91;1820;4114
1280;05.09.2019;61;96;35;63;610;1456
1281;19.06.2019;55;79;24;69;1687;1280
1282;17.06.2019;53;56;3;94;4801;4368
1283;03.02.2020;20;32;12;62;1530;2601
1284;13.11.2019;17;47;30;36;1252;1275
1285;06.10.2019;83;106;23;78;230;3426
1286;12.05.2019;75;87;12;86;4226;3379
1287;03.02.2020;100;102;2;98;2183;2346
1288;22.01.2020;23;50;27;46;4636;1358
1289;03.11.2019;77;106;29;72;743;3153
1290;11.05.2019;92;108;16;85;4825;3051
1291;17.11.2019;60;71;11;84;4224;733
1292;27.12.2019;33;44;11;75;814;2483
1293;19.02.2020;82;108;26;75;2737;1684
1294;12.06.2019;88;100;12;88;3217;1411
1295;08.05.2019;35;39;4;89;3363;3778
1296;23.08.2019;2;24;22;8;4576;1594
1297;22.07.2019;57;95;38;60;2196;3738
1298;14.05.2019;45;70;25;64;1319;3411
1299;01.10.2019;45;69;24;65;3581;432
1300;20.06.2019;34;44;10;77;1404;1725
1301;18.03.2020;38;59;21;64;834;1083
1302;05.06.2019;28;34;6;82;1592;2707
1303;09.07.2019;20;56;36;35;3392;2765
1304;14.01.2020;27;42;15;64;3055;308
1305;28.10.2019;41;44;3;93;2021;3662
1306;14.07.2019;39;78;39;50;2728;677
1307;14.06.2019;12;47;35;25;3640;4504
1308;25.09.2019;83;110;27;75;4901;3631
1309;19.11.2019;93;125;32;74;3380;108
1310;04.11.2019;44;64;20;68;2718;1282
1311;23.08.2019;29;45;16;64;3160;160
1312;23.09.2019;28;49;21;57;2195;3654
1313;05.03.2020;44;70;26;62;2950;2398
1314;15.04.2019;32;41;9;78;3954;2807
1315;14.01.2020;33;70;37;47;3898;4317
1316;03.03.2020;68;69;1;98;3736;2973
1317;20.10.2019;49;67;18;73;4839;2580
1318;27.05.2019;5;38;33;13;890;4375
1319;18.07.2019;61;62;1;98;2341;3827
1320;07.09.2019;38;68;30;55;4807;2986
1321;29.08.2019;85;90;5;94;1538;1661
1322;01.12.2019;89;98;9;90;1948;1649
1323;28.01.2020;48;70;22;68;2202;3882
1324;12.03.2020;84;113;29;74;1944;1347
1325;21.04.2019;66;90;24;73;2604;695
1326;19.12.2019;73;101;28;72;4784;4328
1327;17.02.2020;49;85;36;57;1691;1810
1328;21.08.2019;100;131;31;76;4459;802
1329;23.03.2020;54;93;39;58;3749;738
1330;05.01.2020;11;14;3;78;1606;4348
1331;10.03.2020;20;43;23;46;4607;2142
1332;26.12.2019;66;103;37;64;554;19
1333;20.11.2019;46;59;13;77;3876;1774
1334;13.02.2020;91;119;28;76;767;3705
1335;12.02.2020;49;78;29;62;2910;998
1336;31.05.2019;59;83;24;71;2512;3864
1337;14.04.2019;22;45;23;48;1297;1632
1338;05.05.2019;11;37;26;29;2049;4810
1339;05.05.2019;76;111;35;68;3328;836
1340;07.06.2019;82;86;4;95;4056;2979
1341;06.09.2019;89;97;8;91;1347;2712
1342;03.08.2019;56;87;31;64;3695;216
1343;05.08.2019;10;11;1;90;455;2557
1344;19.10.2019;24;48;24;50;427;3917
1345;19.09.2019;77;90;13;85;3336;4579
1346;03.09.2019;56;96;40;58;4699;3271
1347;07.02.2020;56;81;25;69;2650;1420
1348;04.09.2019;23;57;34;40;2792;2221
1349;01.03.2020;77;105;28;73;4415;1667
1350;06.09.2019;93;129;36;72;50;804
1351;17.09.2019;100;102;2;98;289;2470
1352;04.09.2019;81;113;32;71;843;534
1353;16.05.2019;69;101;32;68;2659;2543
1354;20.08.2019;92;106;14;86;2845;4998
1355;23.11.2019;58;85;27;68;3744;2757
1356;02.01.2020;55;72;17;76;610;3313
1357;13.01.2020;24;57;33;42;2949;856
1358;14.02.2020;6;13;7;46;2550;4883
1359;18.03.2020;39;68;29;57;4836;327
1360;05.05.2019;93;113;20;82;3522;3444
1361;03.12.2019;71;77;6;92;3654;1727
1362;13.12.2019;73;90;17;81;4345;4676
1363;04.05.2019;31;33;2;93;3895;4213
1364;06.11.2019;83;89;6;93;4242;2586
1365;05.10.2019;15;24;9;62;226;3588
1366;12.09.2019;22;34;12;64;60;3473
1367;24.07.2019;99;110;11;90;2107;800
1368;04.07.2019;6;21;15;28;1232;2254
1369;29.08.2019;2;12;10;16;4212;1639
1370;21.05.2019;10;26;16;38;4582;3747
1371;16.05.2019;37;55;18;67;3284;201
1372;04.06.2019;44;82;38;53;4919;666
1373;12.08.2019;29;48;19;60;817;1529
1374;23.05.2019;64;89;25;71;259;3124
1375;11.08.2019;27;64;37;42;4824;4810
1376;30.10.2019;40;73;33;54;611;2098
1377;29.06.2019;91;119;28;76;1271;2282
1378;03.05.2019;55;79;24;69;4346;1244
1379;16.10.2019;81;85;4;95;3347;3004
1380;25.04.2019;2;3;1;66;3652;3011
1381;11.08.2019;6;17;11;35;3895;206
1382;28.06.2019;36;51;15;70;3085;1992
1383;02.01.2020;38;61;23;62;1536;2851
1384;05.06.2019;18;25;7;72;4366;2053
1385;16.11.2019;28;58;30;48;3317;4198
1386;05.01.2020;100;106;6;94;24;4720
1387;17.08.2019;94;107;13;87;4796;4715
1388;16.09.2019;91;103;12;88;4112;4471
1389;23.07.2019;75;79;4;94;830;1834
1390;24.12.2019;21;49;28;42;985;493
1391;23.09.2019;91;119;28;76;4270;804
1392;09.10.2019;43;59;16;72;1881;2105
1393;03.07.2019;97;123;26;78;4033;4089
1394;02.11.2019;81;99;18;81;1891;1052
1395;10.09.2019;59;61;2;96;1197;2730
1396;24.02.2020;77;109;32;70;680;3375
1397;02.03.2020;50;73;23;68;203;1294
1398;10.03.2020;52;72;20;72;841;4785
1399;19.12.2019;9;38;29;23;1321;3535
1400;20.08.2019;51;53;2;96;473;1909
1401;18.08.2019;81;120;39;67;3060;3180
1402;22.12.2019;26;55;29;47;1327;3274
1403;01.07.2019;37;44;7;84;4574;1663
1404;29.06.2019;1;37;36;2;4620;1463
1405;25.10.2019;39;72;33;54;4470;1609
1406;13.07.2019;77;98;21;78;3010;3249
1407;25.10.2019;85;91;6;93;4682;2541
1408;18.08.2019;10;18;8;55;3126;4332
1409;29.10.2019;2;33;31;6;2307;427
1410;09.03.2020;66;79;13;83;337;3014
1411;22.04.2019;34;67;33;50;3993;2988
1412;25.07.2019;56;74;18;75;543;2300
1413;22.06.2019;79;110;31;71;484;4761
1414;29.09.2019;45;48;3;93;1324;2579
1415;24.04.2019;31;41;10;75;1587;1556
1416;16.02.2020;64;77;13;83;1358;4936
1417;29.10.2019;26;50;24;52;3302;2860
1418;04.01.2020;60;99;39;60;4210;4048
1419;19.05.2019;82;116;34;70;4546;657
1420;30.05.2019;34;64;30;53;4168;3931
1421;23.01.2020;69;97;28;71;3525;2854
1422;11.09.2019;28;55;27;50;2365;16
1423;04.08.2019;84;103;19;81;1417;2227
1424;15.07.2019;95;127;32;74;4789;3096
1425;08.12.2019;86;105;19;81;4942;3785
1426;20.09.2019;17;45;28;37;568;1763
1427;29.01.2020;69;85;16;81;3272;3443
1428;14.02.2020;19;33;14;57;1313;3294
1429;21.11.2019;41;59;18;69;1755;3472
1430;13.03.2020;45;62;17;72;1250;1290
1431;01.11.2019;62;99;37;62;4754;2059
1432;10.08.2019;24;39;15;61;3376;2479
1433;01.09.2019;19;49;30;38;1473;4220
1434;06.03.2020;35;49;14;71;2167;2807
1435;05.11.2019;83;86;3;96;1454;308
1436;19.12.2019;90;114;24;78;2259;777
1437;27.05.2019;76;100;24;76;358;2989
1438;14.09.2019;7;8;1;87;4727;1226
1439;07.09.2019;78;100;22;78;1365;2204
1440;12.05.2019;96;132;36;72;2284;2996
1441;16.10.2019;72;110;38;65;2602;3919
1442;18.01.2020;51;80;29;63;58;2056
1443;06.10.2019;32;58;26;55;2938;2240
1444;12.08.2019;3;38;35;7;4220;2841
1445;26.02.2020;89;92;3;96;1596;4214
1446;06.08.2019;31;45;14;68;662;190
1447;21.05.2019;41;69;28;59;2969;3678
1448;03.04.2019;69;82;13;84;4188;2820
1449;28.02.2020;97;116;19;83;2017;2585
1450;12.11.2019;5;40;35;12;4980;524
1451;07.11.2019;92;112;20;82;2810;253
1452;10.05.2019;72;108;36;66;3881;3619
1453;19.01.2020;57;81;24;70;3429;2883
1454;13.06.2019;89;99;10;89;2689;600
1455;24.09.2019;29;68;39;42;2873;3056
1456;31.05.2019;7;30;23;23;2491;4370
1457;28.10.2019;51;74;23;68;288;200
1458;30.07.2019;5;22;17;22;2298;3017
1459;11.02.2020;75;114;39;65;3698;4599
1460;12.07.2019;26;45;19;57;2301;3365
1461;14.01.2020;58;93;35;62;1833;1330
1462;27.02.2020;58;66;8;87;4721;4562
1463;09.10.2019;36;71;35;50;3199;4883
1464;22.03.2020;71;109;38;65;4765;775
1465;11.06.2019;31;48;17;64;801;4848
1466;20.06.2019;88;111;23;79;3857;3132
1467;14.07.2019;70;101;31;69;4379;4091
1468;07.08.2019;99;138;39;71;3304;814
1469;12.04.2019;49;74;25;66;854;3799
1470;21.06.2019;52;88;36;59;2637;4611
1471;02.03.2020;57;59;2;96;3169;2046
1472;03.04.2019;46;63;17;73;1177;4633
1473;01.02.2020;23;35;12;65;1248;3937
1474;30.08.2019;57;69;12;82;2900;1168
1475;08.06.2019;90;111;21;81;1237;4885
1476;05.10.2019;64;69;5;92;383;2934
1477;16.05.2019;16;42;26;38;3296;4539
1478;18.07.2019;51;72;21;70;594;152
1479;20.03.2020;42;59;17;71;1859;4367
1480;07.08.2019;83;102;19;81;4136;1655
1481;04.11.2019;81;82;1;98;884;3519
1482;09.09.2019;45;52;7;86;1750;2718
1483;25.08.2019;47;54;7;87;1375;1305
1484;17.06.2019;78;85;7;91;201;4212
1485;28.08.2019;27;47;20;57;1212;2469
1486;08.08.2019;76;85;9;89;4036;3461
1487;20.02.2020;47;84;37;55;2267;3505
1488;02.05.2019;44;78;34;56;73;3567
1489;12.03.2020;65;76;11;85;3141;317
1490;25.06.2019;76;113;37;67;4748;3859
1491;10.03.2020;76;94;18;80;380;517
1492;25.04.2019;43;53;10;81;4534;291
1493;13.03.2020;26;52;26;50;3298;2194
1494;19.02.2020;92;102;10;90;4206;2812
1495;26.04.2019;53;57;4;92;151;2836
1496;18.05.2019;14;26;12;53;1177;4454
1497;06.07.2019;40;53;13;75;1816;2585
1498;18.03.2020;14;18;4;77;710;1192
1499;01.05.2019;86;88;2;97;1327;808
1500;04.08.2019;14;25;11;56;4228;196
1501;05.06.2019;17;21;4;80;2596;3178
1502;03.04.2019;58;67;9;86;4239;1688
1503;20.08.2019;89;107;18;83;1679;865
1504;19.10.2019;1;17;16;5;2610;4766
1505;13.02.2020;70;100;30;70;2825;1022
1506;10.02.2020;70;72;2;97;2780;2361
1507;02.08.2019;19;55;36;34;4575;1052
1508;19.11.2019;61;80;19;76;1237;285
1509;21.01.2020;62;64;2;96;986;827
1510;27.09.2019;43;67;24;64;911;2303
1511;02.09.2019;91;119;28;76;1900;35
1512;20.11.2019;55;68;13;80;2653;2389
1513;09.09.2019;12;47;35;25;2910;2402
1514;31.01.2020;54;68;14;79;4755;2135
1515;10.12.2019;49;73;24;67;1940;696
1516;24.04.2019;82;111;29;73;4215;300
1517;23.08.2019;82;109;27;75;4214;3042
1518;31.08.2019;72;80;8;90;3963;3045
1519;06.01.2020;14;29;15;48;3762;2805
1520;30.08.2019;14;53;39;26;1604;1442
1521;19.03.2020;23;38;15;60;4595;3804
1522;10.05.2019;56;84;28;66;1293;1738
1523;05.09.2019;26;43;17;60;2420;711
1524;17.10.2019;7;10;3;70;4779;3352
1525;31.10.2019;70;99;29;70;1407;3515
1526;10.11.2019;57;95;38;60;923;2850
1527;03.11.2019;80;83;3;96;4041;736
1528;22.11.2019;80;118;38;67;4786;3919
1529;10.01.2020;98;133;35;73;4629;4458
1530;15.03.2020;75;114;39;65;4297;4262
1531;24.12.2019;31;51;20;60;4225;3210
1532;12.05.2019;34;63;29;53;4392;2832
1533;09.07.2019;1;26;25;3;980;4661
1534;11.11.2019;50;76;26;65;1403;2637
1535;22.07.2019;65;86;21;75;1266;3373
1536;13.03.2020;2;13;11;15;3497;4418
1537;20.03.2020;49;85;36;57;3484;1125
1538;23.10.2019;24;29;5;82;4440;4402
1539;03.08.2019;64;77;13;83;465;3715
1540;15.03.2020;83;107;24;77;124;1360
1541;20.09.2019;10;23;13;43;452;4491
1542;09.02.2020;1;6;5;16;746;3947
1543;04.04.2019;90;102;12;88;157;3761
1544;16.05.2019;45;56;11;80;475;880
1545;28.12.2019;91;111;20;81;2560;4420
1546;04.04.2019;49;52;3;94;1682;2812
1547;03.01.2020;67;92;25;72;2914;1033
1548;05.10.2019;63;74;11;85;419;2308
1549;27.05.2019;90;100;10;90;2171;3334
1550;09.01.2020;71;90;19;78;493;3803
1551;23.02.2020;92;112;20;82;4564;3566
1552;29.04.2019;31;41;10;75;1634;916
1553;23.12.2019;45;49;4;91;271;1607
1554;15.04.2019;77;93;16;82;1610;4062
1555;03.06.2019;9;33;24;27;3784;1009
1556;27.08.2019;14;45;31;31;9;25
1557;23.11.2019;60;93;33;64;4968;3301
1558;09.07.2019;74;87;13;85;2549;4784
1559;25.07.2019;21;36;15;58;339;4026
1560;21.09.2019;1;18;17;5;4161;3854
1561;30.01.2020;25;37;12;67;83;3668
1562;11.04.2019;22;59;37;37;4942;3928
1563;14.02.2020;91;122;31;74;3688;2639
1564;25.12.2019;82;118;36;69;2733;3835
1565;06.05.2019;15;34;19;44;636;1397
1566;05.12.2019;8;32;24;25;1812;4238
1567;21.12.2019;49;63;14;77;3697;4453
1568;25.09.2019;36;60;24;60;2212;2139
1569;23.07.2019;8;13;5;61;3743;574
1570;17.06.2019;98;105;7;93;2886;1972
1571;20.08.2019;47;77;30;61;3450;424
1572;24.08.2019;86;124;38;69;1217;4226
1573;29.03.2019;76;113;37;67;2409;3218
1574;09.05.2019;24;40;16;60;310;4891
1575;31.10.2019;19;42;23;45;3136;2479
1576;19.05.2019;27;36;9;75;3605;1632
1577;13.02.2020;22;23;1;95;2495;4911
1578;08.04.2019;60;85;25;70;3763;2247
1579;17.05.2019;54;79;25;68;3728;2211
1580;21.01.2020;50;79;29;63;3192;4040
1581;19.10.2019;66;78;12;84;3790;743
1582;23.01.2020;36;46;10;78;4961;1697
1583;27.02.2020;70;110;40;63;4853;4511
1584;29.07.2019;66;83;17;79;885;3534
1585;12.11.2019;83;120;37;69;1933;2085
1586;16.06.2019;42;47;5;89;3062;1898
1587;15.04.2019;55;67;12;82;1168;2476
1588;12.04.2019;53;91;38;58;634;3635
1589;13.11.2019;19;48;29;39;3442;2749
1590;30.07.2019;54;67;13;80;4916;2383
1591;17.08.2019;68;103;35;66;1046;3547
1592;03.06.2019;54;69;15;78;2023;220
1593;05.12.2019;79;82;3;96;1810;3422
1594;19.09.2019;90;120;30;75;4216;4765
1595;11.04.2019;44;81;37;54;548;2399
1596;08.12.2019;64;77;13;83;4594;1864
1597;29.06.2019;11;17;6;64;2386;200
1598;15.08.2019;53;61;8;86;1827;4409
1599;30.07.2019;86;87;1;98;1965;442
1600;12.02.2020;67;71;4;94;3474;2571
1601;22.06.2019;86;124;38;69;1582;2763
1602;17.04.2019;5;25;20;20;2767;2464
1603;10.02.2020;80;98;18;81;2061;535
1604;31.12.2019;30;68;38;44;4499;4969
1605;17.07.2019;26;28;2;92;1278;1449
1606;18.08.2019;17;56;39;30;1505;151
1607;25.04.2019;19;45;26;42;2671;3396
1608;24.06.2019;61;93;32;65;3945;4108
1609;10.03.2020;85;108;23;78;1083;453
1610;03.02.2020;78;109;31;71;2443;376
1611;17.08.2019;46;72;26;63;3060;397
1612;04.04.2019;93;117;24;79;3599;3480
1613;24.06.2019;40;61;21;65;526;35
1614;18.08.2019;73;113;40;64;3323;3651
1615;16.09.2019;19;52;33;36;2765;1869
1616;12.01.2020;82;96;14;85;4460;3741
1617;16.03.2020;37;52;15;71;1214;3937
1618;06.03.2020;86;104;18;82;1461;2781
1619;16.01.2020;75;100;25;75;964;2204
1620;25.07.2019;98;108;10;90;3647;3627
1621;23.09.2019;2;29;27;6;733;4096
1622;19.03.2020;42;71;29;59;979;2846
1623;25.04.2019;57;61;4;93;224;841
1624;18.04.2019;39;66;27;59;2;3546
1625;12.11.2019;92;94;2;97;946;2243
1626;21.11.2019;9;39;30;23;1690;427
1627;06.11.2019;42;78;36;53;4375;3434
1628;18.02.2020;12;35;23;34;2816;67
1629;29.04.2019;22;42;20;52;792;3542
1630;10.11.2019;65;77;12;84;1358;653
1631;14.02.2020;39;48;9;81;2746;2874
1632;08.04.2019;33;46;13;71;4317;1017
1633;21.03.2020;39;52;13;75;1756;4405
1634;16.10.2019;73;102;29;71;3713;3992
1635;13.10.2019;89;96;7;92;86;1726
1636;27.05.2019;49;69;20;71;4495;2339
1637;07.03.2020;82;97;15;84;4312;1289
1638;10.10.2019;13;47;34;27;617;1802
1639;25.05.2019;27;40;13;67;3918;2517
1640;08.02.2020;44;71;27;61;3907;4454
1641;30.11.2019;27;32;5;84;4504;2295
1642;17.02.2020;21;53;32;39;2349;635
1643;12.01.2020;86;124;38;69;4039;3593
1644;10.07.2019;15;55;40;27;616;213
1645;26.10.2019;27;62;35;43;2958;3659
1646;24.11.2019;69;104;35;66;3357;4659
1647;21.03.2020;27;35;8;77;2722;1584
1648;31.08.2019;53;79;26;67;785;1615
1649;01.09.2019;40;50;10;80;1837;598
1650;08.03.2020;55;93;38;59;3341;199
1651;29.03.2019;58;76;18;76;2744;3045
1652;13.12.2019;8;19;11;42;2526;4646
1653;12.05.2019;23;54;31;42;545;3710
1654;31.08.2019;16;41;25;39;3482;4426
1655;06.06.2019;31;61;30;50;919;1874
1656;16.08.2019;68;103;35;66;4976;157
1657;25.06.2019;33;66;33;50;3436;4114
1658;22.01.2020;71;103;32;68;1965;4048
1659;24.04.2019;50;76;26;65;3471;2811
1660;31.03.2019;41;45;4;91;2024;2837
1661;11.11.2019;4;44;40;9;1931;3631
1662;09.01.2020;89;103;14;86;3925;4585
1663;06.07.2019;30;62;32;48;942;1802
1664;16.02.2020;56;76;20;73;1443;3637
1665;17.06.2019;31;47;16;65;1183;3462
1666;05.05.2019;56;74;18;75;312;403
1667;24.08.2019;50;73;23;68;791;4705
1668;10.03.2020;40;45;5;88;1857;4712
1669;30.05.2019;28;64;36;43;4612;2399
1670;28.09.2019;11;45;34;24;4923;2241
1671;14.11.2019;19;34;15;55;729;2193
1672;21.11.2019;12;35;23;34;1891;836
1673;26.02.2020;78;94;16;82;2455;448
1674;12.08.2019;8;41;33;19;4431;270
1675;25.11.2019;70;106;36;66;4284;4871
1676;20.06.2019;49;50;1;98;3771;2847
1677;22.06.2019;89;98;9;90;3352;1210
1678;13.03.2020;4;21;17;19;4875;1271
1679;05.02.2020;73;89;16;82;2929;4174
1680;08.10.2019;62;81;19;76;2881;874
1681;05.03.2020;99;121;22;81;4913;2549
1682;03.02.2020;2;38;36;5;3246;2994
1683;26.10.2019;44;78;34;56;2186;289
1684;18.12.2019;7;47;40;14;3124;3986
1685;20.05.2019;25;55;30;45;4181;4853
1686;19.09.2019;14;53;39;26;1998;1192
1687;24.05.2019;22;50;28;44;216;3852
1688;17.01.2020;97;111;14;87;3221;518
1689;05.02.2020;60;100;40;60;4908;2871
1690;15.05.2019;72;74;2;97;2695;2533
1691;05.09.2019;64;71;7;90;179;3075
1692;19.12.2019;62;87;25;71;596;2230
1693;14.08.2019;8;12;4;66;4279;2514
1694;11.02.2020;6;45;39;13;530;1444
1695;18.12.2019;60;80;20;75;2136;4338
1696;06.03.2020;12;16;4;75;3243;390
1697;27.10.2019;48;62;14;77;3400;3273
1698;08.06.2019;64;94;30;68;1883;793
1699;23.05.2019;45;59;14;76;1196;4284
1700;20.11.2019;100;125;25;80;184;270
1701;26.07.2019;35;75;40;46;1522;4044
1702;10.10.2019;50;89;39;56;1106;2682
1703;12.06.2019;56;74;18;75;612;4238
1704;23.12.2019;27;32;5;84;4289;4544
1705;06.01.2020;10;39;29;25;3952;4242
1706;24.06.2019;61;72;11;84;4007;2342
1707;25.12.2019;90;105;15;85;2642;2138
1708;17.04.2019;39;78;39;50;4524;1460
1709;13.01.2020;90;128;38;70;3567;2256
1710;08.03.2020;15;51;36;29;1032;1265
1711;04.08.2019;92;104;12;88;1001;2907
1712;07.12.2019;38;40;2;95;2205;2449
1713;11.08.2019;28;53;25;52;4343;1683
1714;07.09.2019;4;17;13;23;1317;1022
1715;07.11.2019;37;57;20;64;4737;1087
1716;19.05.2019;84;90;6;93;2620;316
1717;01.11.2019;49;61;12;80;3834;388
1718;15.08.2019;94;99;5;94;1450;905
1719;24.07.2019;93;123;30;75;4445;2805
1720;26.12.2019;35;36;1;97;216;2645
1721;01.06.2019;65;87;22;74;4624;2308
1722;10.08.2019;79;89;10;88;4832;1020
1723;27.10.2019;18;48;30;37;8;4748
1724;28.08.2019;14;40;26;35;3341;4753
1725;24.02.2020;12;52;40;23;2668;3933
1726;09.05.2019;80;103;23;77;2632;4377
1727;15.10.2019;94;109;15;86;3025;2620
1728;13.09.2019;22;26;4;84;4738;2890
1729;10.06.2019;37;56;19;66;2573;3779
1730;10.09.2019;46;81;35;56;3830;928
1731;04.03.2020;17;20;3;85;1986;1188
1732;14.06.2019;40;73;33;54;1593;2171
1733;25.03.2020;1;25;24;4;1178;3526
1734;27.10.2019;81;120;39;67;2129;3592
1735;27.07.2019;10;45;35;22;1595;885
1736;16.01.2020;52;58;6;89;1730;2225
1737;03.01.2020;21;35;14;60;3051;1478
1738;25.08.2019;81;96;15;84;3530;4140
1739;04.10.2019;37;43;6;86;494;4960
1740;02.07.2019;7;39;32;17;34;1623
1741;18.01.2020;3;15;12;20;4659;2827
1742;06.01.2020;76;79;3;96;2949;2107
1743;17.08.2019;9;25;16;36;2109;1036
1744;03.02.2020;20;26;6;76;1050;3445
1745;15.06.2019;88;122;34;72;1084;4628
1746;23.08.2019;12;38;26;31;732;642
1747;22.01.2020;72;76;4;94;859;2342
1748;17.07.2019;69;99;30;69;3940;2201
1749;07.08.2019;89;105;16;84;860;4436
1750;03.01.2020;47;87;40;54;4352;3238
1751;18.11.2019;35;72;37;48;4485;2781
1752;05.01.2020;69;86;17;80;4448;611
1753;21.01.2020;68;78;10;87;1321;4711
1754;08.06.2019;50;53;3;94;3278;2910
1755;11.12.2019;44;67;23;65;801;3196
1756;17.07.2019;12;49;37;24;999;4260
1757;02.10.2019;99;129;30;76;4420;4754
1758;24.08.2019;33;64;31;51;207;3247
1759;24.12.2019;70;92;22;76;1512;1530
1760;31.10.2019;22;26;4;84;4130;4857
1761;03.11.2019;75;110;35;68;3803;815
1762;05.09.2019;34;65;31;52;2391;2875
1763;05.11.2019;82;96;14;85;1626;3122
1764;25.04.2019;16;53;37;30;2239;3538
1765;20.06.2019;86;94;8;91;3100;3171
1766;29.06.2019;87;120;33;72;1368;3471
1767;16.11.2019;3;12;9;25;480;1308
1768;07.07.2019;72;94;22;76;1342;1079
1769;06.12.2019;40;67;27;59;2527;4048
1770;17.04.2019;34;74;40;45;2701;802
1771;25.01.2020;36;44;8;81;2389;2727
1772;19.01.2020;36;49;13;73;2457;1696
1773;10.04.2019;16;52;36;30;3903;3100
1774;23.09.2019;23;30;7;76;3015;3242
1775;07.01.2020;98;113;15;86;2738;1807
1776;07.06.2019;24;61;37;39;3517;342
1777;13.05.2019;19;37;18;51;4702;149
1778;24.07.2019;23;57;34;40;1826;1351
1779;06.11.2019;96;97;1;98;322;485
1780;08.09.2019;71;76;5;93;2021;1873
1781;08.07.2019;31;66;35;46;2325;4780
1782;31.05.2019;91;111;20;81;3125;2612
1783;15.05.2019;39;51;12;76;1039;1746
1784;13.01.2020;35;60;25;58;4238;3925
1785;13.07.2019;78;100;22;78;1088;3986
1786;21.06.2019;79;102;23;77;71;3106
1787;25.04.2019;14;18;4;77;2997;1167
1788;21.05.2019;2;38;36;5;1943;2963
1789;19.12.2019;56;72;16;77;4869;2505
1790;31.07.2019;25;27;2;92;2904;852
1791;27.08.2019;35;40;5;87;4091;3008
1792;24.08.2019;38;54;16;70;4672;717
1793;13.07.2019;42;63;21;66;47;2420
1794;18.03.2020;59;62;3;95;1771;1757
1795;02.10.2019;3;27;24;11;3356;811
1796;01.02.2020;18;30;12;60;195;949
1797;23.11.2019;58;64;6;90;1379;2281
1798;02.07.2019;78;84;6;92;499;13
1799;18.05.2019;66;81;15;81;2518;47
1800;18.10.2019;88;102;14;86;4569;849
1801;05.03.2020;66;74;8;89;536;322
1802;03.12.2019;36;60;24;60;1931;4427
1803;16.03.2020;94;129;35;72;4688;4715
1804;09.05.2019;87;108;21;80;2387;3276
1805;16.12.2019;55;69;14;79;3407;3703
1806;10.02.2020;96;104;8;92;1085;2202
1807;29.07.2019;25;26;1;96;1129;2721
1808;22.02.2020;37;51;14;72;2395;349
1809;02.02.2020;27;64;37;42;2527;3492
1810;22.02.2020;38;62;24;61;770;3823
1811;01.05.2019;7;36;29;19;517;3349
1812;09.09.2019;60;67;7;89;4582;823
1813;15.01.2020;90;91;1;98;1811;4848
1814;31.08.2019;12;14;2;85;4608;2447
1815;23.07.2019;96;121;25;79;1757;1321
1816;26.07.2019;10;48;38;20;2941;1199
1817;19.05.2019;59;90;31;65;4719;4099
1818;02.02.2020;22;52;30;42;3393;32
1819;04.05.2019;17;53;36;32;913;1954
1820;20.04.2019;96;120;24;80;4227;2523
1821;21.08.2019;47;77;30;61;1237;1023
1822;08.03.2020;13;39;26;33;1461;4447
1823;23.09.2019;73;112;39;65;857;4800
1824;10.04.2019;48;62;14;77;1515;2132
1825;08.06.2019;87;96;9;90;4837;3224
1826;06.06.2019;68;103;35;66;3415;2258
1827;01.06.2019;94;126;32;74;826;622
1828;12.12.2019;61;64;3;95;4684;2618
1829;17.07.2019;52;81;29;64;2478;2827
1830;06.09.2019;97;113;16;85;4493;4699
1831;24.06.2019;92;93;1;98;2769;1883
1832;12.09.2019;86;89;3;96;2372;323
1833;21.11.2019;14;33;19;42;417;2575
1834;29.10.2019;37;64;27;57;2263;4940
1835;18.03.2020;22;52;30;42;1916;2555
1836;17.01.2020;96;117;21;82;885;1211
1837;28.04.2019;16;41;25;39;1604;70
1838;29.08.2019;34;62;28;54;4359;1881
1839;28.08.2019;31;45;14;68;3086;3219
1840;26.08.2019;16;20;4;80;1767;3905
1841;19.10.2019;93;95;2;97;1418;1715
1842;08.08.2019;63;69;6;91;486;4306
1843;02.12.2019;69;92;23;75;1187;1449
1844;20.08.2019;23;29;6;79;2786;3018
1845;17.04.2019;64;93;29;68;2562;4653
1846;24.12.2019;22;33;11;66;1455;4188
1847;08.03.2020;18;42;24;42;930;4071
1848;19.02.2020;8;48;40;16;3292;1037
1849;29.10.2019;19;52;33;36;457;3699
1850;24.09.2019;42;58;16;72;3556;2017
1851;13.06.2019;76;106;30;71;687;3312
1852;27.03.2020;67;100;33;67;4483;2663
1853;13.09.2019;98;112;14;87;688;4883
1854;05.04.2019;62;82;20;75;1648;2877
1855;26.09.2019;34;69;35;49;692;1606
1856;07.08.2019;74;113;39;65;2778;895
1857;14.02.2020;14;52;38;26;2843;4932
1858;20.04.2019;72;80;8;90;3319;4594
1859;05.02.2020;43;69;26;62;2174;2018
1860;20.09.2019;65;85;20;76;994;339
1861;03.12.2019;20;48;28;41;1518;934
1862;21.11.2019;68;99;31;68;608;3094
1863;30.10.2019;17;55;38;30;940;1658
1864;26.07.2019;62;94;32;65;4391;1586
1865;20.03.2020;70;93;23;75;3502;1940
1866;23.05.2019;61;83;22;73;721;2370
1867;07.03.2020;44;74;30;59;4558;2180
1868;26.09.2019;3;10;7;30;3279;3033
1869;24.05.2019;13;38;25;34;1046;4998
1870;23.08.2019;96;126;30;76;2171;4010
1871;07.05.2019;8;44;36;18;3264;2280
1872;31.01.2020;69;87;18;79;4580;2066
1873;19.11.2019;52;66;14;78;4352;1181
1874;17.02.2020;50;69;19;72;3192;291
1875;05.08.2019;21;51;30;41;4798;4745
1876;07.12.2019;8;18;10;44;3345;945
1877;07.02.2020;89;115;26;77;4018;1394
1878;16.11.2019;49;87;38;56;3227;4025
1879;19.02.2020;31;34;3;91;2820;2535
1880;06.11.2019;67;73;6;91;4827;3244
1881;17.05.2019;51;55;4;92;2644;1031
1882;12.02.2020;53;80;27;66;3641;3861
1883;07.08.2019;78;93;15;83;1133;551
1884;01.08.2019;18;48;30;37;4036;257
1885;07.07.2019;86;124;38;69;1223;3091
1886;21.02.2020;19;43;24;44;2234;1871
1887;12.06.2019;31;59;28;52;2727;4607
1888;19.05.2019;71;99;28;71;4484;191
1889;16.10.2019;60;96;36;62;2300;2535
1890;20.01.2020;90;113;23;79;1383;2622
1891;06.12.2019;10;35;25;28;2401;750
1892;16.09.2019;79;99;20;79;2861;403
1893;13.08.2019;32;51;19;62;4968;771
1894;19.05.2019;43;52;9;82;461;3815
1895;13.10.2019;1;34;33;2;2828;813
1896;18.09.2019;60;61;1;98;3323;3900
1897;08.03.2020;48;65;17;73;54;1346
1898;10.11.2019;8;35;27;22;3488;3591
1899;31.12.2019;2;34;32;5;3113;830
1900;03.08.2019;43;74;31;58;4400;1605
1901;07.03.2020;3;15;12;20;99;3644
1902;11.05.2019;62;70;8;88;2559;3550
1903;18.06.2019;11;20;9;55;1554;3639
1904;20.04.2019;28;35;7;80;2322;1606
1905;05.11.2019;26;40;14;65;2387;3135
1906;01.06.2019;94;105;11;89;1942;4595
1907;15.10.2019;75;77;2;97;4539;828
1908;03.05.2019;5;9;4;55;4516;3462
1909;23.05.2019;78;109;31;71;3541;1120
1910;21.02.2020;57;78;21;73;2852;4825
1911;30.12.2019;76;104;28;73;4854;1147
1912;30.11.2019;26;66;40;39;2750;1475
1913;29.07.2019;93;132;39;70;2480;4443
1914;19.10.2019;13;36;23;36;2846;1846
1915;14.09.2019;97;109;12;88;3748;4156
1916;16.12.2019;14;25;11;56;3433;1679
1917;09.03.2020;45;83;38;54;140;3389
1918;24.08.2019;24;43;19;55;495;4744
1919;09.12.2019;43;71;28;60;1477;1394
1920;28.06.2019;17;22;5;77;1000;4050
1921;27.10.2019;37;60;23;61;1116;28
1922;06.12.2019;91;96;5;94;2495;898
1923;24.09.2019;23;25;2;92;2629;3098
1924;04.05.2019;12;28;16;42;1001;2680
1925;03.09.2019;98;103;5;95;580;1935
1926;19.02.2020;75;106;31;70;1682;2589
1927;04.02.2020;19;35;16;54;4421;1107
1928;08.04.2019;29;52;23;55;1084;3341
1929;03.11.2019;31;56;25;55;3111;1885
1930;05.01.2020;17;18;1;94;1020;976
1931;08.09.2019;51;68;17;75;4460;2707
1932;20.12.2019;79;103;24;76;4191;2932
1933;16.09.2019;30;46;16;65;183;3283
1934;04.12.2019;70;86;16;81;4365;4403
1935;25.05.2019;66;75;9;88;2006;3927
1936;13.04.2019;51;52;1;98;274;693
1937;31.07.2019;36;57;21;63;2324;2360
1938;25.09.2019;26;28;2;92;4017;4694
1939;15.01.2020;26;27;1;96;310;4449
1940;23.08.2019;20;39;19;51;1540;861
1941;15.02.2020;83;117;34;70;3721;3028
1942;08.11.2019;29;61;32;47;3269;1034
1943;11.02.2020;95;135;40;70;4873;3672
1944;08.04.2019;20;28;8;71;1528;2858
1945;03.04.2019;42;67;25;62;4965;1174
1946;25.07.2019;16;46;30;34;4819;336
1947;07.10.2019;84;114;30;73;3905;2388
1948;02.05.2019;98;122;24;80;1172;254
1949;16.03.2020;86;104;18;82;1312;4807
1950;22.04.2019;21;55;34;38;497;4005
1951;20.10.2019;77;78;1;98;1781;549
1952;22.03.2020;91;130;39;70;1714;3969
1953;12.06.2019;58;80;22;72;590;4458
1954;28.09.2019;30;39;9;76;2153;3840
1955;12.12.2019;37;66;29;56;2423;1618
1956;12.05.2019;74;91;17;81;2213;1208
1957;04.04.2019;84;90;6;93;4505;2291
1958;14.02.2020;17;30;13;56;3251;145
1959;22.11.2019;27;48;21;56;1506;3861
1960;29.07.2019;60;81;21;74;1052;1525
1961;19.08.2019;87;90;3;96;4504;715
1962;15.04.2019;49;60;11;81;2382;1375
1963;04.01.2020;7;8;1;87;4913;1297
1964;01.02.2020;60;67;7;89;4080;1875
1965;20.11.2019;31;60;29;51;4370;3429
1966;21.12.2019;45;53;8;84;4179;477
1967;27.03.2020;61;82;21;74;4096;1692
1968;13.07.2019;91;127;36;71;3783;31
1969;15.01.2020;40;79;39;50;4334;4307
1970;30.09.2019;1;36;35;2;1445;4339
1971;28.09.2019;52;81;29;64;2447;3805
1972;11.02.2020;16;54;38;29;4271;1659
1973;15.06.2019;72;100;28;72;3274;1251
1974;04.05.2019;65;105;40;61;2168;839
1975;19.09.2019;22;38;16;57;1373;2762
1976;25.04.2019;96;100;4;96;746;1970
1977;07.06.2019;69;85;16;81;2242;449
1978;29.11.2019;63;102;39;61;3393;1533
1979;24.10.2019;71;100;29;71;1035;4759
1980;13.07.2019;33;48;15;68;2156;569
1981;09.06.2019;23;27;4;85;3522;3935
1982;12.01.2020;52;76;24;68;1444;2261
1983;27.06.2019;84;117;33;71;4936;1588
1984;06.10.2019;51;69;18;73;3790;2799
1985;12.01.2020;85;110;25;77;3087;4424
1986;04.02.2020;21;48;27;43;3683;1228
1987;06.04.2019;11;48;37;22;152;3778
1988;29.12.2019;45;54;9;83;157;1667
1989;06.01.2020;95;116;21;81;681;3095
1990;20.10.2019;66;73;7;90;617;4796
1991;20.10.2019;34;50;16;68;2861;1230
1992;21.12.2019;68;100;32;68;2356;561
1993;08.01.2020;38;59;21;64;275;4405
1994;09.08.2019;65;68;3;95;2860;821
1995;03.10.2019;12;40;28;30;2549;3625
1996;02.10.2019;82;101;19;81;338;769
1997;10.05.2019;92;96;4;95;3721;1363
1998;04.06.2019;30;70;40;42;743;463
1999;14.03.2020;88;109;21;80;1853;1119
2000;29.06.2019;83;86;3;96;2143;503
2001;25.10.2019;98;105;7;93;702;407
2002;26.09.2019;72;84;12;85;402;3719
2003;29.04.2019;4;11;7;36;1321;386
2004;23.05.2019;20;58;38;34;2657;2629
2005;21.04.2019;84;103;19;81;4342;3698
2006;14.01.2020;9;26;17;34;2566;1974
2007;02.09.2019;30;61;31;49;1680;1779
2008;02.06.2019;68;91;23;74;3244;4218
2009;30.07.2019;46;62;16;74;2485;1965
2010;20.09.2019;17;50;33;34;1711;2808
2011;18.12.2019;17;33;16;51;539;2322
2012;07.07.2019;19;26;7;73;2116;4969
2013;21.02.2020;79;105;26;75;4990;1784
2014;26.11.2019;2;28;26;7;3548;1731
2015;27.06.2019;60;66;6;90;1848;240
2016;15.07.2019;79;118;39;66;1780;2610
2017;16.08.2019;92;104;12;88;258;2741
2018;04.08.2019;46;62;16;74;4916;3928
2019;23.09.2019;30;32;2;93;4554;244
2020;30.01.2020;24;47;23;51;1411;4469
2021;18.10.2019;61;91;30;67;3774;4356
2022;19.11.2019;57;83;26;68;84;3174
2023;20.03.2020;31;67;36;46;2232;84
2024;22.09.2019;75;95;20;78;4377;1542
2025;09.04.2019;61;88;27;69;3760;3394
2026;03.10.2019;1;20;19;5;3665;2750
2027;06.01.2020;34;72;38;47;1397;1760
2028;16.02.2020;15;47;32;31;2299;17
2029;17.04.2019;25;38;13;65;2199;4876
2030;21.03.2020;52;64;12;81;4741;2229
2031;04.08.2019;33;57;24;57;2918;2129
2032;06.11.2019;68;94;26;72;2126;1045
2033;21.12.2019;79;107;28;73;4765;4700
2034;07.02.2020;7;34;27;20;4610;4255
2035;13.09.2019;69;101;32;68;3953;424
2036;12.01.2020;47;71;24;66;2216;825
2037;01.10.2019;85;124;39;68;4885;1108
2038;03.02.2020;92;106;14;86;1861;1576
2039;27.03.2020;28;40;12;70;2507;471
2040;23.07.2019;73;95;22;76;3734;2597
2041;13.01.2020;43;51;8;84;2312;783
2042;22.12.2019;32;49;17;65;3124;4635
2043;18.11.2019;31;46;15;67;472;602
2044;14.07.2019;71;79;8;89;2924;2548
2045;29.05.2019;30;50;20;60;1934;838
2046;10.06.2019;97;101;4;96;4203;3646
2047;19.09.2019;38;47;9;80;110;1108
2048;03.05.2019;70;109;39;64;1356;3413
2049;07.09.2019;32;59;27;54;2934;3092
2050;26.02.2020;68;80;12;85;4668;772
2051;21.11.2019;40;47;7;85;2364;1503
2052;26.01.2020;99;126;27;78;549;2468
2053;20.01.2020;51;74;23;68;4488;3154
2054;28.11.2019;66;70;4;94;2180;511
2055;21.12.2019;76;86;10;88;1917;2064
2056;02.09.2019;43;60;17;71;1649;3207
2057;12.09.2019;64;75;11;85;3224;1076
2058;21.05.2019;12;50;38;24;334;3509
2059;27.08.2019;76;96;20;79;4001;1527
2060;01.03.2020;20;34;14;58;2173;1480
2061;07.05.2019;83;88;5;94;1291;2468
2062;07.09.2019;75;98;23;76;4619;1004
2063;20.10.2019;26;38;12;68;2038;925
2064;11.06.2019;66;72;6;91;203;4803
2065;26.09.2019;28;50;22;56;22;4908
2066;10.06.2019;3;23;20;13;1639;3781
2067;25.01.2020;61;94;33;64;4649;3916
2068;01.04.2019;63;84;21;75;95;327
2069;31.05.2019;68;106;38;64;3601;2420
2070;22.02.2020;55;95;40;57;2113;3394
2071;20.09.2019;47;50;3;94;1706;287
2072;25.08.2019;28;68;40;41;4716;669
2073;17.08.2019;99;104;5;95;713;1384
2074;13.07.2019;22;50;28;44;3283;4766
2075;29.01.2020;44;56;12;78;3219;1304
2076;09.07.2019;99;128;29;77;716;4289
2077;17.05.2019;99;137;38;72;3182;3504
2078;08.01.2020;81;116;35;69;214;3153
2079;10.02.2020;29;33;4;87;4031;1520
2080;22.06.2019;23;44;21;52;2921;553
2081;06.06.2019;52;67;15;77;2015;4943
2082;09.05.2019;13;17;4;76;2811;4564
2083;17.03.2020;21;44;23;47;879;224
2084;05.07.2019;45;59;14;76;486;1729
2085;11.09.2019;33;34;1;97;4705;1197
2086;08.05.2019;14;52;38;26;310;3346
2087;14.04.2019;17;37;20;45;3949;253
2088;08.05.2019;81;101;20;80;525;800
2089;05.08.2019;65;83;18;78;1209;3188
2090;04.01.2020;30;69;39;43;3816;4
2091;22.04.2019;29;40;11;72;3634;820
2092;03.03.2020;36;39;3;92;911;4941
2093;10.03.2020;7;31;24;22;2607;4644
2094;17.05.2019;45;59;14;76;905;433
2095;20.09.2019;35;43;8;81;909;448
2096;14.05.2019;99;134;35;73;4880;4724
2097;30.03.2019;78;105;27;74;231;146
2098;12.07.2019;89;104;15;85;4857;3704
2099;11.07.2019;92;105;13;87;4176;4011
2100;27.03.2020;8;32;24;25;3001;4133
2101;04.01.2020;47;81;34;58;266;4537
2102;22.12.2019;71;72;1;98;2618;466
2103;21.07.2019;55;85;30;64;826;1312
2104;03.06.2019;57;72;15;79;385;4811
2105;05.10.2019;67;98;31;68;143;1430
2106;02.01.2020;61;86;25;70;3967;1488
2107;19.09.2019;81;82;1;98;1128;743
2108;07.07.2019;63;88;25;71;2839;2514
2109;28.01.2020;47;84;37;55;3302;1755
2110;04.05.2019;48;71;23;67;3098;1811
2111;14.07.2019;54;69;15;78;4362;1492
2112;05.04.2019;47;60;13;78;2143;1578
2113;06.09.2019;83;92;9;90;1233;1350
2114;30.08.2019;85;103;18;82;478;1983
2115;12.12.2019;3;13;10;23;1820;2438
2116;01.12.2019;55;79;24;69;1326;803
2117;13.08.2019;62;89;27;69;3844;2846
2118;04.04.2019;30;35;5;85;738;755
2119;03.02.2020;21;58;37;36;4123;1220
2120;27.04.2019;57;73;16;78;4967;3453
2121;06.11.2019;12;16;4;75;255;3696
2122;13.08.2019;48;80;32;60;894;958
2123;08.06.2019;45;65;20;69;2451;1099
2124;23.08.2019;65;102;37;63;270;3118
2125;21.08.2019;2;12;10;16;3166;14
2126;26.12.2019;16;26;10;61;4493;2634
2127;03.04.2019;50;66;16;75;2525;480
2128;30.10.2019;6;15;9;40;491;2297
2129;24.07.2019;27;62;35;43;409;2076
2130;20.03.2020;61;80;19;76;2260;3061
2131;30.12.2019;77;105;28;73;4916;71
2132;06.11.2019;64;74;10;86;1689;1800
2133;19.03.2020;43;79;36;54;2710;2040
2134;18.10.2019;68;96;28;70;3641;2853
2135;07.02.2020;67;74;7;90;4976;698
2136;25.09.2019;62;96;34;64;467;1148
2137;22.01.2020;79;81;2;97;2338;3703
2138;16.08.2019;26;41;15;63;946;312
2139;28.05.2019;76;93;17;81;1536;3236
2140;21.05.2019;49;61;12;80;2816;338
2141;03.01.2020;32;68;36;47;1779;3586
2142;11.06.2019;91;104;13;87;3401;4255
2143;05.12.2019;69;99;30;69;4723;1329
2144;27.09.2019;71;104;33;68;696;2197
2145;04.11.2019;77;85;8;90;182;978
2146;11.04.2019;8;14;6;57;1724;1216
2147;14.08.2019;82;104;22;78;2693;1473
2148;23.10.2019;39;66;27;59;4743;4531
2149;21.04.2019;82;84;2;97;3296;2307
2150;26.12.2019;35;75;40;46;2519;2605
2151;25.09.2019;89;126;37;70;1587;927
2152;08.06.2019;32;38;6;84;2542;2992
2153;07.09.2019;77;91;14;84;2872;3760
2154;22.07.2019;75;101;26;74;2399;2787
2155;22.01.2020;2;19;17;10;4321;4787
2156;09.10.2019;80;113;33;70;4886;740
2157;14.02.2020;25;47;22;53;3959;3457
2158;03.03.2020;32;44;12;72;3081;2816
2159;04.05.2019;59;95;36;62;4445;1170
2160;04.10.2019;97;116;19;83;345;2356
2161;04.11.2019;5;24;19;20;2581;1080
2162;23.08.2019;1;33;32;3;216;1081
2163;02.05.2019;35;63;28;55;2104;2665
2164;28.08.2019;7;8;1;87;1884;4753
2165;02.09.2019;98;132;34;74;1185;4026
2166;18.12.2019;78;113;35;69;1275;4949
2167;07.03.2020;21;28;7;75;8;680
2168;13.08.2019;44;77;33;57;4523;1616
2169;22.08.2019;5;40;35;12;3875;2278
2170;03.12.2019;20;57;37;35;1563;552
2171;02.12.2019;19;39;20;48;3637;2378
2172;20.04.2019;64;78;14;82;1504;2271
2173;11.10.2019;12;44;32;27;4497;1381
2174;21.03.2020;68;98;30;69;864;2820
2175;23.01.2020;70;75;5;93;4436;802
2176;06.07.2019;80;114;34;70;615;3741
2177;04.08.2019;12;35;23;34;3027;1057
2178;17.04.2019;35;51;16;68;2967;294
2179;25.08.2019;86;119;33;72;3606;1759
2180;03.02.2020;78;102;24;76;125;4948
2181;06.01.2020;51;79;28;64;1830;4448
2182;21.04.2019;52;61;9;85;3704;3231
2183;01.04.2019;96;98;2;97;1004;2460
2184;16.06.2019;98;100;2;98;3764;860
2185;21.08.2019;21;53;32;39;709;3940
2186;05.07.2019;14;28;14;50;1662;1188
2187;28.05.2019;81;114;33;71;200;3283
2188;24.08.2019;46;62;16;74;2075;1411
2189;18.07.2019;60;99;39;60;4535;2594
2190;01.09.2019;4;34;30;11;2449;3114
2191;11.12.2019;13;26;13;50;1293;3276
2192;20.02.2020;38;66;28;57;387;3675
2193;20.12.2019;79;119;40;66;4308;3192
2194;15.03.2020;71;95;24;74;1700;2607
2195;31.12.2019;30;31;1;96;2340;4260
2196;21.04.2019;27;59;32;45;4221;431
2197;29.11.2019;86;99;13;86;2665;666
2198;19.09.2019;40;47;7;85;4958;142
2199;28.08.2019;78;81;3;96;4061;590
2200;31.12.2019;76;86;10;88;3763;1973
2201;10.07.2019;69;93;24;74;4095;39
2202;14.12.2019;79;102;23;77;3239;4207
2203;10.07.2019;23;24;1;95;1158;2825
2204;01.01.2020;45;76;31;59;774;3725
2205;24.12.2019;20;59;39;33;779;2282
2206;13.02.2020;98;117;19;83;3232;45
2207;29.07.2019;86;106;20;81;2032;3401
2208;25.12.2019;43;72;29;59;2046;4383
2209;25.01.2020;1;31;30;3;3348;4336
2210;11.11.2019;92;109;17;84;4817;3516
2211;31.08.2019;17;48;31;35;598;1346
2212;28.06.2019;49;77;28;63;3131;4772
2213;09.10.2019;4;9;5;44;759;3109
2214;03.08.2019;22;55;33;40;2945;2566
2215;09.09.2019;73;112;39;65;4356;3785
2216;08.01.2020;86;125;39;68;1861;1974
2217;13.11.2019;88;122;34;72;245;4154
2218;12.05.2019;36;67;31;53;3906;4120
2219;27.08.2019;32;68;36;47;1692;2027
2220;24.08.2019;19;26;7;73;444;1456
2221;27.09.2019;63;102;39;61;689;4187
2222;02.08.2019;82;84;2;97;3418;1892
2223;23.09.2019;46;77;31;59;139;4368
2224;03.03.2020;31;34;3;91;4501;2403
2225;31.01.2020;45;68;23;66;3452;4565
2226;17.12.2019;91;103;12;88;4505;257
2227;07.09.2019;100;122;22;81;1098;3633
2228;15.08.2019;93;131;38;70;4021;3404
2229;24.06.2019;52;87;35;59;622;3455
2230;08.11.2019;39;54;15;72;1008;1489
2231;06.08.2019;86;90;4;95;1191;107
2232;27.04.2019;51;70;19;72;4115;4323
2233;01.09.2019;28;31;3;90;1513;4867
2234;26.09.2019;65;96;31;67;2403;95
2235;23.12.2019;74;75;1;98;4489;2254
2236;28.09.2019;93;107;14;86;3862;1107
2237;20.06.2019;61;88;27;69;1864;894
2238;17.10.2019;57;93;36;61;4849;339
2239;22.04.2019;8;9;1;88;4191;3760
2240;07.02.2020;69;107;38;64;1193;3344
2241;11.03.2020;18;51;33;35;2535;3895
2242;11.08.2019;11;23;12;47;1577;1008
2243;23.08.2019;43;76;33;56;1643;2395
2244;19.04.2019;70;85;15;82;3227;540
2245;15.12.2019;29;63;34;46;1023;3893
2246;26.08.2019;4;9;5;44;3549;2989
2247;06.04.2019;39;41;2;95;4047;736
2248;22.06.2019;57;63;6;90;2829;4899
2249;26.07.2019;97;111;14;87;1310;4004
2250;15.10.2019;68;94;26;72;2242;3554
2251;21.04.2019;71;78;7;91;4;1281
2252;21.12.2019;18;46;28;39;434;3246
2253;02.12.2019;12;29;17;41;61;3704
2254;11.11.2019;100;102;2;98;958;3717
2255;29.10.2019;6;7;1;85;2397;3287
2256;11.04.2019;76;112;36;67;4613;2650
2257;15.04.2019;35;70;35;50;2914;1020
2258;02.04.2019;84;116;32;72;3288;2522
2259;19.01.2020;96;121;25;79;66;660
2260;21.04.2019;31;38;7;81;4886;4548
2261;22.12.2019;79;107;28;73;1376;4483
2262;25.10.2019;63;68;5;92;200;4659
2263;12.04.2019;99;123;24;80;4467;2696
2264;04.12.2019;31;66;35;46;1402;3439
2265;02.05.2019;73;90;17;81;3789;1859
2266;26.07.2019;37;50;13;74;4043;199
2267;09.08.2019;77;82;5;93;4071;1420
2268;21.05.2019;15;53;38;28;4992;3682
2269;12.02.2020;78;79;1;98;695;2952
2270;16.06.2019;6;36;30;16;3952;422
2271;20.10.2019;22;30;8;73;1163;3838
2272;14.09.2019;80;97;17;82;382;1442
2273;15.03.2020;80;81;1;98;3083;1776
2274;13.10.2019;42;50;8;84;2027;4287
2275;04.07.2019;11;21;10;52;3257;474
2276;29.02.2020;98;118;20;83;2512;3310
2277;27.08.2019;75;92;17;81;976;1856
2278;14.08.2019;62;65;3;95;815;1246
2279;07.06.2019;66;85;19;77;3594;3979
2280;26.12.2019;83;111;28;74;4581;4891
2281;29.05.2019;66;98;32;67;3146;1470
2282;16.02.2020;72;84;12;85;1902;2023
2283;13.01.2020;89;100;11;89;3910;2638
2284;24.01.2020;53;82;29;64;4937;573
2285;10.11.2019;26;58;32;44;2210;3594
2286;24.12.2019;44;61;17;72;4379;2536
2287;03.04.2019;78;81;3;96;236;3733
2288;24.05.2019;10;23;13;43;4836;1429
2289;06.08.2019;5;11;6;45;760;3035
2290;17.08.2019;67;78;11;85;2057;2649
2291;26.09.2019;36;58;22;62;2457;1404
2292;29.01.2020;62;67;5;92;1478;3963
2293;21.11.2019;87;119;32;73;959;2702
2294;08.02.2020;87;120;33;72;688;1299
2295;11.05.2019;56;73;17;76;4408;1615
2296;21.02.2020;83;95;12;87;2314;3434
2297;31.07.2019;71;99;28;71;341;2482
2298;17.06.2019;5;18;13;27;2543;1326
2299;14.01.2020;40;51;11;78;2669;3694
2300;01.10.2019;47;71;24;66;3862;2372
2301;18.05.2019;72;104;32;69;2850;391
2302;15.10.2019;62;86;24;72;1384;2416
2303;21.09.2019;11;15;4;73;1048;4920
2304;10.04.2019;83;89;6;93;4257;804
2305;30.12.2019;52;56;4;92;871;4101
2306;09.07.2019;62;83;21;74;445;41
2307;04.10.2019;4;15;11;26;3700;2625
2308;18.07.2019;1;25;24;4;4000;277
2309;01.02.2020;74;97;23;76;1882;4932
2310;04.04.2019;93;120;27;77;529;2992
2311;12.04.2019;6;31;25;19;4250;2792
2312;22.01.2020;2;40;38;5;796;1752
2313;09.06.2019;73;82;9;89;356;2769
2314;08.11.2019;57;93;36;61;1384;930
2315;22.10.2019;31;59;28;52;4407;2617
2316;15.01.2020;93;130;37;71;1368;2786
2317;16.05.2019;34;48;14;70;4546;3501
2318;06.04.2019;70;74;4;94;332;2931
2319;17.10.2019;52;91;39;57;4855;4701
2320;29.11.2019;81;89;8;91;1099;4959
2321;06.07.2019;97;102;5;95;2902;2974
2322;21.10.2019;78;106;28;73;353;1467
2323;20.01.2020;37;52;15;71;734;719
2324;26.09.2019;59;93;34;63;4824;124
2325;02.09.2019;9;14;5;64;4435;4844
2326;23.09.2019;19;34;15;55;4278;3275
2327;20.03.2020;17;32;15;53;3610;4346
2328;01.03.2020;55;56;1;98;4127;2967
2329;12.06.2019;19;55;36;34;3281;3906
2330;27.05.2019;11;12;1;91;2836;1722
2331;22.05.2019;95;101;6;94;3537;1600
2332;26.03.2020;62;95;33;65;1497;1087
2333;15.04.2019;76;92;16;82;1233;307
2334;25.01.2020;32;63;31;50;3835;643
2335;05.12.2019;97;127;30;76;2020;4697
2336;07.02.2020;60;91;31;65;4407;2252
2337;12.09.2019;12;33;21;36;1150;1802
2338;23.01.2020;36;58;22;62;1619;851
2339;29.03.2019;27;31;4;87;4882;2742
2340;13.05.2019;17;42;25;40;932;4420
2341;26.10.2019;100;122;22;81;3602;4569
2342;23.02.2020;65;73;8;89;1607;2261
2343;08.04.2019;52;86;34;60;2040;2524
2344;25.10.2019;46;64;18;71;1011;4210
2345;05.09.2019;5;20;15;25;1986;4942
2346;09.04.2019;66;74;8;89;1385;1818
2347;10.01.2020;18;23;5;78;482;2249
2348;02.12.2019;55;67;12;82;830;4441
2349;06.06.2019;90;101;11;89;57;2584
2350;12.08.2019;73;87;14;83;303;13
2351;22.07.2019;16;50;34;32;4157;4725
2352;21.08.2019;7;14;7;50;1903;498
2353;20.06.2019;41;60;19;68;4206;4344
2354;01.07.2019;1;10;9;10;2296;4066
2355;12.03.2020;43;52;9;82;3262;3555
2356;19.11.2019;37;40;3;92;2576;370
2357;13.08.2019;61;65;4;93;1053;989
2358;11.01.2020;38;41;3;92;4198;3562
2359;23.08.2019;53;61;8;86;3874;3630
2360;28.05.2019;11;21;10;52;3804;4862
2361;29.07.2019;100;130;30;76;3838;1922
2362;13.10.2019;12;47;35;25;848;808
2363;10.01.2020;38;78;40;48;4039;3377
2364;25.05.2019;22;56;34;39;2604;854
2365;21.03.2020;94;112;18;83;3948;351
2366;07.03.2020;5;21;16;23;1258;2888
2367;06.08.2019;12;37;25;32;2384;692
2368;29.03.2019;69;81;12;85;3156;2347
2369;05.08.2019;57;94;37;60;1989;400
2370;11.06.2019;11;51;40;21;2846;1238
2371;19.01.2020;12;42;30;28;4573;3565
2372;09.04.2019;50;75;25;66;3146;3931
2373;20.09.2019;8;9;1;88;4541;2409
2374;29.02.2020;85;109;24;77;2761;118
2375;09.09.2019;61;70;9;87;553;928
2376;02.10.2019;30;65;35;46;828;3465
2377;28.01.2020;40;64;24;62;4768;3918
2378;26.05.2019;38;43;5;88;3452;1660
2379;07.03.2020;41;58;17;70;3834;3547
2380;12.03.2020;97;137;40;70;4335;310
2381;16.10.2019;89;101;12;88;2231;1193
2382;09.09.2019;37;73;36;50;3227;2109
2383;03.10.2019;18;26;8;69;2315;4222
2384;04.05.2019;35;45;10;77;4537;1659
2385;18.08.2019;14;34;20;41;4945;2795
2386;04.06.2019;20;47;27;42;4010;2690
2387;14.07.2019;38;73;35;52;1901;2249
2388;23.08.2019;24;60;36;40;3847;3063
2389;27.02.2020;13;51;38;25;3847;1427
2390;24.06.2019;46;70;24;65;687;859
2391;02.07.2019;52;56;4;92;2276;4840
2392;06.06.2019;26;54;28;48;3051;4702
2393;27.12.2019;98;112;14;87;3678;2942
2394;06.04.2019;61;81;20;75;260;3069
2395;23.08.2019;84;111;27;75;4068;4800
2396;18.03.2020;8;40;32;20;747;1735
2397;16.04.2019;93;132;39;70;2270;2463
2398;21.10.2019;55;56;1;98;2777;1999
2399;06.05.2019;55;69;14;79;668;3807
2400;16.11.2019;45;63;18;71;3042;4198
2401;24.12.2019;74;90;16;82;4777;3051
2402;14.08.2019;66;72;6;91;727;3979
2403;07.09.2019;76;99;23;76;1643;3298
2404;29.10.2019;46;54;8;85;3447;1921
2405;28.02.2020;64;86;22;74;914;4181
2406;20.07.2019;83;101;18;82;3377;1723
2407;29.12.2019;73;79;6;92;2153;707
2408;06.10.2019;44;79;35;55;2448;3947
2409;07.08.2019;37;56;19;66;299;462
2410;29.12.2019;92;121;29;76;1842;4840
2411;31.08.2019;49;78;29;62;2570;4383
2412;20.07.2019;19;30;11;63;2712;2080
2413;23.01.2020;92;103;11;89;1758;2559
2414;22.06.2019;74;87;13;85;4251;2747
2415;24.08.2019;12;45;33;26;2988;2949
2416;06.06.2019;52;71;19;73;2871;2040
2417;09.03.2020;5;7;2;71;4984;4091
2418;04.01.2020;6;45;39;13;288;1272
2419;01.02.2020;60;86;26;69;598;3062
2420;07.06.2019;36;38;2;94;4300;4392
2421;03.06.2019;9;24;15;37;1035;1295
2422;08.04.2019;84;96;12;87;3417;3482
2423;13.10.2019;47;57;10;82;1484;4436
2424;01.10.2019;47;77;30;61;3372;3945
2425;15.09.2019;28;32;4;87;1491;974
2426;22.12.2019;89;95;6;93;2742;435
2427;16.05.2019;1;13;12;7;2197;1899
2428;28.12.2019;23;37;14;62;3854;1269
2429;16.06.2019;10;33;23;30;799;1342
2430;12.03.2020;35;47;12;74;510;4097
2431;17.10.2019;41;78;37;52;3867;3101
2432;14.03.2020;43;58;15;74;4813;1302
2433;25.02.2020;94;121;27;77;2596;3180
2434;26.03.2020;69;94;25;73;1302;1374
2435;23.09.2019;23;60;37;38;4951;2145
2436;11.03.2020;86;115;29;74;2881;3167
2437;21.05.2019;76;80;4;95;54;2831
2438;09.03.2020;5;29;24;17;1415;28
2439;19.08.2019;56;72;16;77;2300;3723
2440;22.01.2020;41;68;27;60;744;563
2441;09.08.2019;50;81;31;61;2007;3805
2442;06.11.2019;99;134;35;73;950;3046
2443;01.03.2020;81;120;39;67;2107;4872
2444;30.04.2019;79;98;19;80;3188;4555
2445;28.05.2019;59;92;33;64;1643;2567
2446;23.10.2019;31;53;22;58;559;4070
2447;03.03.2020;89;98;9;90;4943;1249
2448;27.04.2019;100;119;19;84;679;3946
2449;07.10.2019;6;31;25;19;236;2449
2450;07.11.2019;86;109;23;78;3162;3561
2451;05.04.2019;16;56;40;28;2836;1534
2452;27.02.2020;16;38;22;42;572;765
2453;30.06.2019;56;71;15;78;103;3631
2454;06.04.2019;77;94;17;81;4073;660
2455;05.04.2019;47;67;20;70;4153;155
2456;28.05.2019;49;51;2;96;3454;3857
2457;03.01.2020;97;104;7;93;3258;2731
2458;08.08.2019;21;42;21;50;2978;3387
2459;20.06.2019;96;97;1;98;1508;1789
2460;01.11.2019;77;107;30;71;1838;174
2461;08.07.2019;48;56;8;85;775;602
2462;18.11.2019;65;101;36;64;2460;2663
2463;11.07.2019;77;95;18;81;1643;1513
2464;19.05.2019;6;42;36;14;1491;2134
2465;27.05.2019;93;130;37;71;4877;203
2466;13.06.2019;93;111;18;83;4779;2903
2467;23.10.2019;42;45;3;93;2237;4563
2468;18.12.2019;88;89;1;98;3883;680
2469;04.09.2019;54;89;35;60;435;4901
2470;09.08.2019;39;58;19;67;4630;4038
2471;30.11.2019;100;126;26;79;2073;352
2472;12.02.2020;9;31;22;29;3262;3290
2473;12.05.2019;78;97;19;80;3595;4366
2474;20.06.2019;80;115;35;69;1826;337
2475;10.02.2020;74;110;36;67;1189;2981
2476;13.06.2019;7;11;4;63;2678;2700
2477;16.05.2019;11;23;12;47;3086;1679
2478;03.08.2019;52;57;5;91;2693;2463
2479;22.12.2019;90;94;4;95;3771;1072
2480;02.04.2019;69;105;36;65;875;4938
2481;31.08.2019;64;74;10;86;349;3932
2482;28.07.2019;99;135;36;73;4068;263
2483;13.09.2019;26;58;32;44;2846;2909
2484;13.06.2019;25;46;21;54;4353;4093
2485;14.06.2019;76;103;27;73;773;4688
2486;06.04.2019;70;110;40;63;4557;3603
2487;26.04.2019;100;121;21;82;1716;815
2488;12.01.2020;10;27;17;37;3077;2821
2489;10.11.2019;41;69;28;59;1089;1331
2490;05.05.2019;34;51;17;66;4779;3006
2491;13.10.2019;73;88;15;82;4731;4137
2492;30.05.2019;11;12;1;91;2152;4733
2493;04.04.2019;93;96;3;96;541;2676
2494;31.01.2020;84;110;26;76;2827;4960
2495;07.09.2019;6;15;9;40;1870;3318
2496;05.03.2020;72;110;38;65;4882;4102
2497;10.01.2020;61;89;28;68;4575;128
2498;17.05.2019;66;81;15;81;4465;1867
2499;19.12.2019;84;108;24;77;14;4692
2500;13.06.2019;70;82;12;85;4613;2628
2501;18.08.2019;87;101;14;86;1905;2141
2502;28.05.2019;61;97;36;62;4738;800
2503;31.12.2019;53;63;10;84;4470;3646
2504;16.03.2020;45;55;10;81;3152;1043
2505;26.01.2020;59;85;26;69;1113;1141
2506;28.01.2020;19;32;13;59;1719;2485
2507;21.09.2019;15;32;17;46;2464;2968
2508;09.12.2019;11;14;3;78;1260;681
2509;21.06.2019;51;58;7;87;515;2846
2510;12.09.2019;85;110;25;77;2812;4617
2511;24.12.2019;40;50;10;80;3248;4811
2512;13.05.2019;99;107;8;92;2145;2219
2513;27.11.2019;18;25;7;72;953;660
2514;14.11.2019;52;72;20;72;4407;1196
2515;13.05.2019;92;99;7;92;4104;1504
2516;01.03.2020;37;59;22;62;2458;4846
2517;24.01.2020;20;41;21;48;1389;4326
2518;23.06.2019;72;112;40;64;698;1193
2519;15.04.2019;23;51;28;45;695;1312
2520;17.01.2020;26;65;39;40;29;308
2521;12.12.2019;69;70;1;98;1058;4687
2522;27.04.2019;31;57;26;54;4424;4682
2523;08.07.2019;81;114;33;71;4368;1411
2524;01.03.2020;70;77;7;90;1612;1061
2525;28.09.2019;21;27;6;77;1931;1972
2526;15.09.2019;97;106;9;91;1412;4697
2527;02.12.2019;88;114;26;77;3610;3303
2528;03.06.2019;52;90;38;57;623;3470
2529;07.02.2020;23;55;32;41;3106;339
2530;29.11.2019;86;112;26;76;3647;767
2531;21.06.2019;5;14;9;35;1044;3458
2532;01.11.2019;89;99;10;89;4561;629
2533;07.11.2019;83;112;29;74;3445;4354
2534;12.10.2019;24;53;29;45;2047;4843
2535;15.05.2019;35;57;22;61;703;2200
2536;08.12.2019;94;103;9;91;3419;1199
2537;22.03.2020;71;88;17;80;2800;4171
2538;24.02.2020;88;112;24;78;1189;3742
2539;27.09.2019;24;50;26;48;2658;4096
2540;25.03.2020;50;89;39;56;2526;4266
2541;08.04.2019;56;80;24;70;711;1806
2542;22.01.2020;89;108;19;82;2129;3191
2543;05.02.2020;99;117;18;84;640;1727
2544;04.01.2020;42;70;28;60;4253;3864
2545;29.07.2019;71;78;7;91;2964;1404
2546;06.12.2019;12;14;2;85;695;3897
2547;20.04.2019;64;92;28;69;139;3453
2548;30.09.2019;84;85;1;98;4884;780
2549;03.10.2019;49;51;2;96;1589;2371
2550;03.09.2019;27;50;23;54;6;3868
2551;01.02.2020;62;99;37;62;681;3300
2552;23.10.2019;86;90;4;95;253;4444
2553;05.07.2019;92;105;13;87;2006;3164
2554;30.05.2019;8;36;28;22;3662;267
2555;15.01.2020;62;102;40;60;2018;1173
2556;23.10.2019;60;86;26;69;3881;1243
2557;25.01.2020;70;89;19;78;1373;1979
2558;21.02.2020;44;76;32;57;2760;4559
2559;29.11.2019;11;39;28;28;4943;644
2560;05.06.2019;93;99;6;93;1326;972
2561;08.02.2020;50;90;40;55;4261;750
2562;15.04.2019;87;110;23;79;2104;3191
2563;10.08.2019;78;105;27;74;1119;2691
2564;17.11.2019;85;103;18;82;741;532
2565;21.08.2019;62;85;23;72;488;3284
2566;12.07.2019;36;50;14;72;3012;885
2567;07.10.2019;77;91;14;84;47;4465
2568;18.06.2019;94;105;11;89;1778;3974
2569;29.02.2020;71;78;7;91;1461;2071
2570;07.11.2019;73;77;4;94;4146;4410
2571;09.01.2020;26;28;2;92;3422;3775
2572;05.01.2020;99;136;37;72;372;4958
2573;14.04.2019;39;47;8;82;2102;597
2574;24.03.2020;15;22;7;68;585;4484
2575;29.01.2020;56;92;36;60;993;1231
2576;16.12.2019;77;108;31;71;1998;2303
2577;08.02.2020;70;95;25;73;446;4644
2578;24.09.2019;97;101;4;96;4447;1576
2579;23.07.2019;75;77;2;97;3559;2091
2580;21.02.2020;81;107;26;75;429;3228
2581;18.03.2020;30;39;9;76;1035;4043
2582;04.08.2019;18;58;40;31;3942;3177
2583;02.02.2020;89;96;7;92;807;2709
2584;06.03.2020;17;50;33;34;3789;4379
2585;24.09.2019;20;23;3;86;4899;1764
2586;25.07.2019;96;112;16;85;590;3047
2587;10.04.2019;44;61;17;72;2600;525
2588;23.08.2019;48;66;18;72;4606;3757
2589;07.02.2020;1;31;30;3;2529;699
2590;18.02.2020;20;51;31;39;2560;149
2591;02.09.2019;53;66;13;80;61;3710
2592;18.01.2020;11;36;25;30;4449;3741
2593;10.06.2019;62;68;6;91;3138;1861
2594;19.11.2019;42;77;35;54;793;2732
2595;25.08.2019;88;101;13;87;3275;4568
2596;29.05.2019;12;25;13;48;2228;1019
2597;22.07.2019;88;96;8;91;547;3024
2598;16.10.2019;92;132;40;69;931;4130
2599;05.08.2019;100;114;14;87;673;448
2600;30.07.2019;10;24;14;41;1767;2136
2601;13.04.2019;81;89;8;91;2821;3481
2602;30.09.2019;9;48;39;18;2709;3728
2603;26.07.2019;76;79;3;96;809;4549
2604;01.08.2019;70;103;33;67;3075;3444
2605;25.03.2020;29;33;4;87;2540;587
2606;25.08.2019;71;95;24;74;3496;2157
2607;04.09.2019;93;102;9;91;3303;4352
2608;05.07.2019;67;74;7;90;3997;61
2609;06.06.2019;16;24;8;66;2099;2358
2610;08.01.2020;99;121;22;81;2537;3890
2611;22.06.2019;61;101;40;60;3817;2883
2612;26.01.2020;74;96;22;77;3980;820
2613;11.11.2019;44;47;3;93;152;309
2614;22.04.2019;57;65;8;87;1613;4046
2615;05.12.2019;72;73;1;98;3669;4971
2616;04.05.2019;2;20;18;10;4376;391
2617;04.01.2020;74;104;30;71;3620;2871
2618;13.07.2019;42;45;3;93;4074;4958
2619;29.07.2019;13;44;31;29;639;1118
2620;10.07.2019;13;22;9;59;2684;670
2621;21.01.2020;40;66;26;60;2598;313
2622;30.09.2019;76;94;18;80;575;4319
2623;13.09.2019;1;24;23;4;2374;419
2624;06.07.2019;82;91;9;90;3659;3780
2625;06.01.2020;51;67;16;76;4737;1017
2626;13.02.2020;86;96;10;89;1562;4250
2627;24.12.2019;33;53;20;62;467;2080
2628;18.04.2019;96;111;15;86;4056;4410
2629;29.02.2020;81;94;13;86;301;4655
2630;07.02.2020;98;101;3;97;1272;201
2631;11.08.2019;94;97;3;96;3642;355
2632;12.02.2020;54;79;25;68;3149;2933
2633;04.09.2019;25;31;6;80;3287;2899
2634;15.01.2020;33;52;19;63;1923;4066
2635;02.10.2019;2;4;2;50;1186;4815
2636;07.03.2020;83;102;19;81;461;3337
2637;23.10.2019;97;98;1;98;1504;539
2638;16.07.2019;38;43;5;88;4397;667
2639;29.02.2020;20;46;26;43;136;2226
2640;02.09.2019;96;129;33;74;3024;2406
2641;05.03.2020;76;105;29;72;4843;4051
2642;31.05.2019;95;119;24;79;4257;3256
2643;05.12.2019;40;57;17;70;3602;1838
2644;09.08.2019;29;64;35;45;953;4124
2645;30.09.2019;55;95;40;57;2386;336
2646;30.09.2019;44;56;12;78;4479;3839
2647;09.06.2019;66;95;29;69;1476;3848
2648;13.11.2019;92;130;38;70;1826;2106
2649;02.08.2019;52;59;7;88;2336;2677
2650;03.03.2020;68;86;18;79;1327;560
2651;19.11.2019;17;28;11;60;532;4917
2652;13.04.2019;22;58;36;37;1401;432
2653;15.01.2020;73;101;28;72;421;382
2654;28.01.2020;95;105;10;90;146;2658
2655;09.01.2020;87;101;14;86;3114;2286
2656;29.01.2020;58;76;18;76;4498;4908
2657;21.10.2019;99;136;37;72;3131;1412
2658;10.10.2019;67;86;19;77;3948;1653
2659;23.09.2019;42;72;30;58;2953;1166
2660;28.02.2020;57;76;19;75;2114;1830
2661;17.12.2019;74;112;38;66;1861;1506
2662;13.09.2019;86;97;11;88;2840;4794
2663;04.11.2019;48;51;3;94;863;4920
2664;20.05.2019;86;104;18;82;3201;1442
2665;15.11.2019;21;58;37;36;4327;742
2666;05.02.2020;10;43;33;23;1671;526
2667;20.06.2019;25;64;39;39;711;3982
2668;27.10.2019;60;84;24;71;1146;1108
2669;16.09.2019;30;33;3;90;4298;4535
2670;08.03.2020;28;62;34;45;1289;2232
2671;29.02.2020;32;60;28;53;446;826
2672;17.04.2019;68;105;37;64;541;3215
2673;26.01.2020;85;96;11;88;127;2223
2674;22.06.2019;80;96;16;83;4777;2261
2675;23.07.2019;18;23;5;78;3572;2511
2676;13.01.2020;17;22;5;77;556;4381
2677;07.03.2020;11;38;27;28;2372;2209
2678;27.12.2019;100;110;10;90;1833;3199
2679;20.11.2019;36;64;28;56;4581;546
2680;18.03.2020;61;98;37;62;1553;2150
2681;22.08.2019;51;83;32;61;1692;1289
2682;29.06.2019;7;32;25;21;3310;4373
2683;15.05.2019;28;50;22;56;1229;4281
2684;13.05.2019;39;41;2;95;3089;3517
2685;08.12.2019;75;94;19;79;494;994
2686;21.07.2019;37;53;16;69;3115;1446
2687;05.07.2019;19;57;38;33;3400;3466
2688;01.10.2019;75;77;2;97;219;2339
2689;03.10.2019;10;20;10;50;2445;2224
2690;14.05.2019;1;33;32;3;1562;740
2691;28.08.2019;11;18;7;61;3652;3968
2692;24.12.2019;29;50;21;58;3053;728
2693;04.01.2020;63;77;14;81;3050;2966
2694;29.10.2019;67;76;9;88;1322;3172
2695;18.01.2020;100;113;13;88;1764;684
2696;15.08.2019;6;32;26;18;3093;3186
2697;29.05.2019;58;67;9;86;383;3688
2698;17.12.2019;95;123;28;77;4259;1992
2699;13.04.2019;35;49;14;71;41;872
2700;12.12.2019;69;104;35;66;2217;4144
2701;26.04.2019;76;81;5;93;1354;276
2702;27.12.2019;92;132;40;69;224;2384
2703;30.10.2019;86;96;10;89;3490;3844
2704;23.05.2019;62;72;10;86;62;3287
2705;05.12.2019;70;107;37;65;1445;444
2706;31.07.2019;72;96;24;75;405;4699
2707;22.04.2019;11;30;19;36;4213;4239
2708;22.07.2019;29;48;19;60;763;4008
2709;21.02.2020;85;104;19;81;4968;447
2710;01.05.2019;21;36;15;58;2997;2484
2711;20.10.2019;57;84;27;67;286;521
2712;13.11.2019;25;60;35;41;230;2094
2713;03.09.2019;50;53;3;94;3418;2899
2714;20.10.2019;33;69;36;47;696;2326
2715;31.07.2019;5;41;36;12;4532;1836
2716;29.08.2019;9;48;39;18;2479;1238
2717;30.09.2019;93;118;25;78;3197;422
2718;09.03.2020;30;45;15;66;86;1098
2719;13.03.2020;52;64;12;81;1991;1973
2720;07.11.2019;23;26;3;88;2773;3112
2721;09.03.2020;54;91;37;59;251;3782
2722;16.12.2019;36;52;16;69;1343;3839
2723;09.11.2019;98;99;1;98;4306;1553
2724;19.07.2019;25;59;34;42;2614;2859
2725;23.07.2019;54;73;19;73;3841;848
2726;17.02.2020;73;111;38;65;103;4285
2727;16.03.2020;81;89;8;91;1883;4092
2728;08.11.2019;63;97;34;64;4494;2668
2729;23.04.2019;19;28;9;67;2438;4003
2730;01.08.2019;64;100;36;64;1163;4547
2731;20.07.2019;31;40;9;77;60;3139
2732;03.12.2019;79;86;7;91;2705;3949
2733;24.08.2019;4;21;17;19;3896;1070
2734;18.10.2019;19;24;5;79;2434;2587
2735;19.04.2019;1;34;33;2;4120;3502
2736;23.09.2019;12;21;9;57;3536;4671
2737;24.06.2019;72;100;28;72;806;3047
2738;25.12.2019;39;59;20;66;4425;2526
2739;10.03.2020;43;72;29;59;2526;2717
2740;04.12.2019;35;64;29;54;2904;3800
2741;27.01.2020;84;110;26;76;448;1089
2742;17.04.2019;54;55;1;98;3732;3737
2743;25.02.2020;19;58;39;32;3670;3563
2744;30.04.2019;67;70;3;95;3100;2764
2745;13.08.2019;40;67;27;59;3001;254
2746;26.03.2020;49;78;29;62;3970;4417
2747;01.10.2019;3;40;37;7;1834;2456
2748;07.03.2020;18;20;2;90;2015;929
2749;02.05.2019;1;26;25;3;1808;230
2750;23.01.2020;85;105;20;80;3791;1329
2751;24.09.2019;58;60;2;96;2426;115
2752;24.03.2020;30;59;29;50;420;2006
2753;17.02.2020;5;37;32;13;418;1826
2754;19.12.2019;6;33;27;18;2623;75
2755;26.04.2019;35;49;14;71;2968;2262
2756;04.08.2019;91;128;37;71;406;187
2757;07.05.2019;83;109;26;76;303;1601
2758;24.06.2019;70;84;14;83;1845;2885
2759;16.05.2019;70;93;23;75;3906;3190
2760;08.04.2019;28;35;7;80;3725;2756
2761;28.05.2019;29;57;28;50;2965;3666
2762;08.07.2019;89;100;11;89;3941;3073
2763;27.04.2019;66;81;15;81;3555;1671
2764;10.09.2019;40;60;20;66;4446;131
2765;24.01.2020;42;78;36;53;2468;2585
2766;17.11.2019;47;73;26;64;2637;2053
2767;26.08.2019;76;80;4;95;4646;4678
2768;21.10.2019;97;123;26;78;782;1235
2769;13.07.2019;73;79;6;92;1093;4215
2770;27.11.2019;22;38;16;57;4059;4714
2771;10.04.2019;9;17;8;52;2646;1575
2772;17.05.2019;28;37;9;75;2036;4963
2773;23.12.2019;29;58;29;50;2991;826
2774;19.11.2019;95;114;19;83;1891;1723
2775;16.01.2020;88;98;10;89;4763;3679
2776;22.10.2019;78;110;32;70;3512;4371
2777;06.11.2019;31;45;14;68;365;4271
2778;22.03.2020;19;52;33;36;154;4167
2779;16.10.2019;23;45;22;51;2654;3035
2780;22.05.2019;21;37;16;56;4357;3169
2781;20.10.2019;81;120;39;67;4396;2046
2782;03.05.2019;87;106;19;82;641;1988
2783;11.01.2020;88;115;27;76;2466;2058
2784;11.05.2019;67;102;35;65;738;3304
2785;14.12.2019;86;96;10;89;4418;3356
2786;06.04.2019;37;74;37;50;649;4854
2787;31.01.2020;34;66;32;51;3092;1643
2788;02.10.2019;26;65;39;40;1990;3231
2789;01.12.2019;26;41;15;63;1598;2037
2790;04.10.2019;8;33;25;24;4923;3469
2791;15.12.2019;24;42;18;57;940;1774
2792;26.03.2020;10;25;15;40;2225;2805
2793;14.11.2019;85;109;24;77;1166;1444
2794;23.09.2019;38;64;26;59;576;995
2795;12.02.2020;5;39;34;12;2638;1649
2796;19.09.2019;25;35;10;71;2382;193
2797;08.01.2020;51;63;12;80;742;3877
2798;25.10.2019;67;71;4;94;2580;3063
2799;13.01.2020;54;81;27;66;2707;2930
2800;11.08.2019;80;82;2;97;2622;104
2801;02.02.2020;51;55;4;92;2165;2536
2802;20.04.2019;13;30;17;43;2514;2249
2803;02.09.2019;28;38;10;73;2017;1093
2804;15.12.2019;58;71;13;81;297;3242
2805;17.12.2019;89;119;30;74;4284;2253
2806;15.11.2019;29;31;2;93;4803;4856
2807;23.05.2019;38;66;28;57;974;1188
2808;09.11.2019;84;92;8;91;2045;545
2809;08.11.2019;93;115;22;80;493;4754
2810;29.06.2019;14;24;10;58;775;460
2811;25.11.2019;17;20;3;85;4082;1091
2812;29.02.2020;6;10;4;60;4835;4099
2813;18.10.2019;21;23;2;91;3194;3507
2814;22.12.2019;42;76;34;55;3531;3831
2815;30.05.2019;60;65;5;92;1271;1449
2816;21.07.2019;89;123;34;72;704;2428
2817;20.08.2019;90;109;19;82;4907;4227
2818;15.07.2019;19;45;26;42;189;2225
2819;23.02.2020;82;113;31;72;3284;1681
2820;25.09.2019;84;95;11;88;3125;3191
2821;14.11.2019;81;103;22;78;3303;4533
2822;13.01.2020;97;114;17;85;921;1722
2823;05.04.2019;90;104;14;86;266;238
2824;09.07.2019;90;102;12;88;4711;3437
2825;29.01.2020;5;25;20;20;1890;2008
2826;22.03.2020;54;65;11;83;735;1963
2827;24.08.2019;46;53;7;86;2935;4416
2828;29.04.2019;86;102;16;84;508;1157
2829;21.02.2020;54;60;6;90;4848;3188
2830;03.09.2019;38;73;35;52;1323;1195
2831;23.09.2019;61;63;2;96;3152;3488
2832;11.10.2019;5;10;5;50;953;3027
2833;11.01.2020;20;39;19;51;377;2110
2834;04.04.2019;75;110;35;68;4711;2925
2835;03.09.2019;42;58;16;72;4506;566
2836;03.11.2019;98;113;15;86;3854;236
2837;14.07.2019;36;68;32;52;3957;2164
2838;09.08.2019;9;36;27;25;4318;2276
2839;09.12.2019;32;39;7;82;615;2277
2840;01.04.2019;84;122;38;68;545;2650
2841;29.12.2019;87;105;18;82;4589;2646
2842;01.01.2020;11;19;8;57;1569;554
2843;31.03.2019;55;56;1;98;2236;2983
2844;12.10.2019;19;40;21;47;1793;3852
2845;02.09.2019;88;116;28;75;823;1949
2846;29.06.2019;4;44;40;9;3458;3370
2847;22.09.2019;89;108;19;82;2344;2930
2848;23.04.2019;97;106;9;91;2242;316
2849;01.03.2020;49;89;40;55;2979;405
2850;12.02.2020;26;49;23;53;3650;1495
2851;18.01.2020;4;10;6;40;1925;3770
2852;10.04.2019;8;11;3;72;2976;2418
2853;27.12.2019;19;58;39;32;2548;2872
2854;22.09.2019;65;95;30;68;2074;4582
2855;29.10.2019;12;47;35;25;3547;361
2856;30.11.2019;35;50;15;70;4606;3328
2857;17.12.2019;93;98;5;94;1078;3881
2858;13.06.2019;46;70;24;65;333;2095
2859;27.01.2020;26;38;12;68;2104;1929
2860;12.02.2020;85;107;22;79;2949;2833
2861;10.02.2020;66;78;12;84;356;2730
2862;26.09.2019;66;98;32;67;1029;907
2863;15.06.2019;2;24;22;8;4715;3995
2864;13.07.2019;56;81;25;69;1984;1452
2865;20.02.2020;13;23;10;56;3151;107
2866;01.02.2020;53;64;11;82;3360;968
2867;15.02.2020;59;63;4;93;2624;2168
2868;15.05.2019;90;129;39;69;788;1645
2869;29.07.2019;57;72;15;79;2847;2965
2870;14.11.2019;7;47;40;14;2286;3200
2871;01.05.2019;22;26;4;84;2063;3545
2872;17.07.2019;8;28;20;28;4422;1203
2873;03.01.2020;34;55;21;61;632;2535
2874;01.09.2019;86;110;24;78;4853;4829
2875;10.06.2019;81;113;32;71;150;1778
2876;14.06.2019;91;101;10;90;573;2101
2877;13.03.2020;46;82;36;56;557;1571
2878;21.11.2019;33;52;19;63;1948;1201
2879;06.03.2020;16;26;10;61;2460;3112
2880;15.09.2019;54;66;12;81;2525;2293
2881;03.05.2019;39;71;32;54;4930;1829
2882;10.08.2019;59;89;30;66;4551;1905
2883;22.07.2019;28;54;26;51;2359;3131
2884;09.02.2020;57;80;23;71;866;3644
2885;11.09.2019;64;69;5;92;128;4782
2886;13.02.2020;7;27;20;25;4707;1579
2887;06.12.2019;13;24;11;54;3100;3246
2888;17.01.2020;73;95;22;76;4338;4399
2889;31.10.2019;47;83;36;56;2686;1881
2890;17.11.2019;100;128;28;78;3708;2287
2891;04.01.2020;27;38;11;71;1800;2323
2892;11.06.2019;3;22;19;13;4869;2156
2893;27.05.2019;27;48;21;56;1019;1587
2894;30.09.2019;35;52;17;67;4058;2742
2895;19.07.2019;73;103;30;70;2356;2289
2896;02.11.2019;57;84;27;67;3326;4082
2897;20.04.2019;21;29;8;72;3746;3142
2898;03.10.2019;41;81;40;50;275;267
2899;24.10.2019;48;63;15;76;219;3861
2900;18.03.2020;89;121;32;73;4291;5
2901;21.03.2020;56;90;34;62;1988;4572
2902;29.01.2020;83;108;25;76;3400;3026
2903;03.10.2019;40;74;34;54;4079;572
2904;03.01.2020;14;22;8;63;568;2303
2905;18.03.2020;32;38;6;84;4287;2203
2906;12.10.2019;55;90;35;61;2869;2411
2907;19.12.2019;63;89;26;70;4413;4830
2908;14.06.2019;92;93;1;98;664;1179
2909;29.02.2020;94;103;9;91;1828;3141
2910;18.08.2019;20;34;14;58;1568;1518
2911;04.04.2019;48;88;40;54;2178;2203
2912;08.03.2020;72;99;27;72;1007;299
2913;01.08.2019;2;40;38;5;447;4263
2914;30.11.2019;2;40;38;5;376;167
2915;04.06.2019;21;43;22;48;2831;3487
2916;31.03.2019;37;44;7;84;2023;677
2917;27.01.2020;95;119;24;79;2333;1135
2918;20.10.2019;53;91;38;58;4758;4924
2919;10.04.2019;59;81;22;72;4534;1172
2920;21.09.2019;54;55;1;98;1333;4795
2921;03.04.2019;93;95;2;97;3980;1291
2922;14.07.2019;90;107;17;84;829;2128
2923;16.02.2020;29;37;8;78;985;3513
2924;15.03.2020;24;43;19;55;3581;3659
2925;17.08.2019;68;97;29;70;1558;2255
2926;08.08.2019;40;62;22;64;4716;2042
2927;13.08.2019;8;46;38;17;4355;1004
2928;21.05.2019;15;23;8;65;2175;3152
2929;06.06.2019;73;112;39;65;2667;2203
2930;14.11.2019;73;84;11;86;4336;2649
2931;05.09.2019;54;66;12;81;2459;4228
2932;17.06.2019;43;65;22;66;863;1785
2933;03.06.2019;76;105;29;72;1507;4278
2934;01.06.2019;91;105;14;86;1736;3387
2935;15.06.2019;95;102;7;93;4881;4128
2936;17.09.2019;26;44;18;59;2552;2162
2937;24.06.2019;77;108;31;71;2957;3438
2938;10.01.2020;96;99;3;96;1645;3717
2939;26.07.2019;61;78;17;78;4649;4507
2940;21.09.2019;47;84;37;55;1788;2663
2941;06.02.2020;50;65;15;76;2059;4233
2942;09.05.2019;41;80;39;51;4917;4949
2943;07.09.2019;75;113;38;66;1689;2117
2944;09.04.2019;9;12;3;75;83;1807
2945;13.06.2019;41;50;9;82;3663;711
2946;25.09.2019;71;106;35;66;2383;4897
2947;18.09.2019;68;74;6;91;465;737
2948;27.08.2019;84;85;1;98;2506;2021
2949;09.01.2020;54;75;21;72;1795;161
2950;25.09.2019;37;47;10;78;4277;4125
2951;19.09.2019;58;84;26;69;3682;1612
2952;18.09.2019;26;47;21;55;3756;4927
2953;04.01.2020;60;66;6;90;263;1799
2954;04.03.2020;63;90;27;70;3128;2863
2955;05.03.2020;15;41;26;36;1998;4367
2956;18.12.2019;91;94;3;96;1352;2351
2957;27.06.2019;16;35;19;45;3239;4729
2958;21.12.2019;55;86;31;63;2261;1879
2959;01.12.2019;17;51;34;33;926;695
2960;14.12.2019;19;59;40;32;4673;1614
2961;27.02.2020;74;100;26;74;1498;1947
2962;25.06.2019;26;60;34;43;1375;15
2963;21.09.2019;10;37;27;27;4132;4396
2964;29.10.2019;94;101;7;93;56;1945
2965;31.08.2019;92;113;21;81;3638;2110
2966;19.02.2020;64;86;22;74;2257;784
2967;17.08.2019;84;99;15;84;4558;2416
2968;10.09.2019;90;99;9;90;3481;1562
2969;03.09.2019;94;95;1;98;1747;2583
2970;08.09.2019;32;35;3;91;1556;3694
2971;20.06.2019;32;52;20;61;3821;4227
2972;23.07.2019;83;107;24;77;2924;537
2973;28.08.2019;77;93;16;82;245;4596
2974;06.09.2019;88;106;18;83;3175;1099
2975;24.03.2020;32;42;10;76;652;4359
2976;17.04.2019;56;75;19;74;2689;759
2977;20.06.2019;70;73;3;95;1526;1458
2978;17.08.2019;93;131;38;70;2198;975
2979;29.08.2019;42;80;38;52;1451;960
2980;13.06.2019;32;58;26;55;4001;4869
2981;13.04.2019;9;12;3;75;4850;1735
2982;20.07.2019;33;71;38;46;1370;846
2983;13.10.2019;38;51;13;74;682;2772
2984;13.10.2019;94;117;23;80;4856;2292
2985;24.10.2019;51;91;40;56;962;4384
2986;30.01.2020;34;51;17;66;1546;3686
2987;07.09.2019;47;49;2;95;3062;4991
2988;07.09.2019;8;36;28;22;4639;3567
2989;25.06.2019;60;80;20;75;4600;448
2990;19.11.2019;92;130;38;70;711;4517
2991;12.07.2019;86;118;32;72;1281;2304
2992;11.11.2019;26;42;16;61;1345;1464
2993;06.11.2019;5;19;14;26;3379;342
2994;23.09.2019;43;55;12;78;4445;4809
2995;13.11.2019;17;35;18;48;3515;3302
2996;16.12.2019;42;70;28;60;664;3983
2997;08.09.2019;41;81;40;50;1446;3795
2998;15.03.2020;1;27;26;3;1366;1855
2999;19.11.2019;34;61;27;55;1825;1007
3000;07.11.2019;44;47;3;93;4932;3320
3001;28.11.2019;74;106;32;69;2095;4305
3002;30.03.2019;4;5;1;80;4006;4102
3003;23.06.2019;2;9;7;22;515;3459
3004;21.12.2019;39;63;24;61;409;1401
3005;09.08.2019;26;44;18;59;1883;1282
3006;14.11.2019;16;35;19;45;2006;3204
3007;22.08.2019;85;113;28;75;3356;671
3008;25.02.2020;9;27;18;33;1964;4059
3009;09.07.2019;99;123;24;80;3964;3773
3010;04.05.2019;30;59;29;50;893;4783
3011;04.01.2020;86;103;17;83;3498;3938
3012;10.01.2020;89;128;39;69;802;3628
3013;13.02.2020;89;111;22;80;872;1902
3014;11.07.2019;99;125;26;79;530;1503
3015;10.11.2019;54;87;33;62;3320;1927
3016;10.06.2019;24;25;1;96;2031;4517
3017;17.09.2019;76;98;22;77;3625;3793
3018;13.08.2019;10;12;2;83;884;781
3019;18.05.2019;34;59;25;57;681;738
3020;17.09.2019;14;40;26;35;2425;2251
3021;04.03.2020;1;28;27;3;4850;1819
3022;09.10.2019;87;91;4;95;2335;4310
3023;12.03.2020;1;11;10;9;3662;1894
3024;27.02.2020;8;9;1;88;4473;891
3025;08.05.2019;11;50;39;22;4331;2546
3026;29.07.2019;65;83;18;78;2343;4697
3027;12.12.2019;96;108;12;88;4462;4790
3028;24.10.2019;59;66;7;89;2338;386
3029;14.04.2019;59;91;32;64;4148;1265
3030;16.03.2020;48;64;16;75;2694;2592
3031;01.06.2019;7;29;22;24;4675;2159
3032;02.12.2019;32;61;29;52;2027;1452
3033;12.09.2019;5;37;32;13;2913;1590
3034;13.07.2019;29;31;2;93;2332;648
3035;05.10.2019;44;62;18;70;2132;4124
3036;23.07.2019;85;121;36;70;3404;4043
3037;20.04.2019;28;55;27;50;275;3257
3038;11.07.2019;31;52;21;59;1234;1703
3039;09.02.2020;35;50;15;70;4373;4875
3040;04.02.2020;44;54;10;81;2162;3406
3041;10.02.2020;30;33;3;90;1163;3588
3042;10.07.2019;41;80;39;51;114;2952
3043;27.05.2019;99;110;11;90;143;1906
3044;13.07.2019;22;47;25;46;3124;2968
3045;20.02.2020;72;92;20;78;799;2145
3046;12.01.2020;76;99;23;76;1323;1479
3047;31.08.2019;32;33;1;96;1526;513
3048;22.02.2020;11;23;12;47;1042;3103
3049;24.09.2019;37;42;5;88;2344;2582
3050;29.06.2019;70;106;36;66;779;3268
3051;03.09.2019;71;99;28;71;1297;1404
3052;09.05.2019;76;90;14;84;3923;1696
3053;08.11.2019;45;65;20;69;4437;2782
3054;16.04.2019;86;116;30;74;4307;2470
3055;04.09.2019;72;78;6;92;3396;2869
3056;24.12.2019;21;56;35;37;163;1844
3057;16.01.2020;46;74;28;62;3789;1132
3058;30.01.2020;50;70;20;71;228;2921
3059;02.02.2020;41;78;37;52;586;4911
3060;12.07.2019;60;95;35;63;1053;4536
3061;17.09.2019;37;47;10;78;993;1847
3062;13.05.2019;29;44;15;65;397;2889
3063;09.09.2019;31;37;6;83;1096;1145
3064;04.05.2019;25;35;10;71;3683;3665
3065;12.01.2020;65;76;11;85;3036;4220
3066;26.09.2019;50;51;1;98;3398;1524
3067;22.10.2019;39;72;33;54;4546;1918
3068;11.07.2019;52;85;33;61;3406;72
3069;24.03.2020;97;134;37;72;2709;17
3070;25.03.2020;41;49;8;83;2382;2856
3071;14.10.2019;20;43;23;46;1409;800
3072;28.01.2020;9;34;25;26;3323;2030
3073;08.07.2019;56;92;36;60;2437;2033
3074;22.07.2019;93;115;22;80;1668;2204
3075;30.04.2019;8;21;13;38;1023;1895
3076;02.06.2019;78;110;32;70;3768;2406
3077;30.07.2019;53;80;27;66;1901;4061
3078;25.01.2020;22;59;37;37;3338;2260
3079;09.08.2019;31;41;10;75;1386;2432
3080;14.06.2019;82;108;26;75;4858;3191
3081;25.05.2019;50;84;34;59;3591;3054
3082;21.04.2019;6;36;30;16;4749;3438
3083;07.10.2019;43;83;40;51;2130;2578
3084;07.06.2019;25;33;8;75;3275;1075
3085;10.09.2019;26;36;10;72;2121;2518
3086;05.11.2019;43;45;2;95;848;1561
3087;15.10.2019;16;38;22;42;4273;2264
3088;09.01.2020;10;44;34;22;1951;443
3089;27.01.2020;66;73;7;90;4774;4078
3090;18.08.2019;60;90;30;66;3561;2152
3091;24.11.2019;82;114;32;71;4237;4991
3092;18.12.2019;86;104;18;82;4521;1864
3093;06.03.2020;29;59;30;49;3889;929
3094;07.02.2020;1;10;9;10;1677;1447
3095;23.10.2019;86;95;9;90;1338;1253
3096;11.01.2020;35;64;29;54;2111;3402
3097;02.10.2019;27;55;28;49;4159;3993
3098;01.08.2019;72;93;21;77;1779;3796
3099;25.07.2019;82;105;23;78;3178;219
3100;15.03.2020;81;112;31;72;76;4413
3101;01.06.2019;68;94;26;72;3137;2370
3102;23.10.2019;61;90;29;67;3906;4209
3103;30.12.2019;69;77;8;89;3627;3887
3104;07.05.2019;2;18;16;11;607;3431
3105;12.04.2019;52;61;9;85;3714;167
3106;13.01.2020;54;61;7;88;2932;2038
3107;20.10.2019;31;70;39;44;2323;227
3108;10.11.2019;92;114;22;80;2572;1487
3109;20.10.2019;28;50;22;56;4908;4941
3110;02.04.2019;4;8;4;50;4201;3855
3111;06.10.2019;13;43;30;30;3984;2597
3112;09.07.2019;78;82;4;95;1161;3959
3113;23.07.2019;83;89;6;93;1672;1440
3114;05.08.2019;52;78;26;66;1447;749
3115;11.11.2019;14;23;9;60;2134;4914
3116;07.04.2019;37;55;18;67;64;2845
3117;02.03.2020;21;29;8;72;3086;304
3118;17.04.2019;15;37;22;40;1136;465
3119;09.11.2019;94;111;17;84;1012;2818
3120;15.03.2020;94;131;37;71;2764;2450
3121;27.02.2020;79;113;34;69;705;2756
3122;18.02.2020;52;77;25;67;162;3502
3123;30.07.2019;33;71;38;46;3910;4927
3124;31.08.2019;71;107;36;66;4077;643
3125;11.07.2019;62;72;10;86;1471;2062
3126;28.06.2019;71;101;30;70;4586;2575
3127;20.04.2019;26;38;12;68;1326;313
3128;08.03.2020;94;103;9;91;1110;1884
3129;17.08.2019;24;25;1;96;13;4272
3130;04.12.2019;85;97;12;87;3179;337
3131;16.05.2019;88;121;33;72;2603;2724
3132;01.12.2019;12;30;18;40;4317;465
3133;17.03.2020;82;91;9;90;4695;1676
3134;26.12.2019;17;35;18;48;1674;1057
3135;13.06.2019;10;27;17;37;2762;3578
3136;30.03.2019;22;60;38;36;4422;4233
3137;10.01.2020;26;28;2;92;3660;1910
3138;03.09.2019;58;64;6;90;3714;2186
3139;12.02.2020;7;17;10;41;3842;2587
3140;08.05.2019;33;71;38;46;1976;2667
3141;11.12.2019;72;91;19;79;4710;1783
3142;20.11.2019;22;45;23;48;4069;2929
3143;19.07.2019;69;105;36;65;2536;586
3144;17.01.2020;59;61;2;96;1840;4356
3145;26.10.2019;56;66;10;84;3517;3270
3146;24.12.2019;18;43;25;41;4194;2471
3147;13.11.2019;99;120;21;82;1253;1946
3148;14.05.2019;15;29;14;51;4875;784
3149;13.01.2020;24;43;19;55;1992;1767
3150;15.08.2019;42;54;12;77;1933;1879
3151;14.06.2019;60;80;20;75;2893;444
3152;07.09.2019;41;62;21;66;1877;2947
3153;09.10.2019;36;44;8;81;923;1185
3154;20.07.2019;23;46;23;50;3574;793
3155;30.09.2019;32;42;10;76;2041;1013
3156;12.11.2019;35;68;33;51;4377;3167
3157;27.03.2020;37;49;12;75;4116;4334
3158;04.08.2019;3;15;12;20;1553;193
3159;20.05.2019;21;31;10;67;3523;3797
3160;29.03.2019;53;69;16;76;743;3186
3161;16.05.2019;11;44;33;25;1934;627
3162;22.06.2019;41;78;37;52;2250;4630
3163;11.09.2019;46;58;12;79;2198;3724
3164;17.02.2020;99;110;11;90;3076;3061
3165;30.12.2019;28;67;39;41;1774;3981
3166;18.04.2019;35;73;38;47;4856;3148
3167;03.11.2019;29;30;1;96;3242;3994
3168;08.06.2019;2;18;16;11;2190;438
3169;29.11.2019;62;93;31;66;3689;2465
3170;29.04.2019;39;46;7;84;1228;1585
3171;04.12.2019;62;71;9;87;866;2959
3172;24.09.2019;13;52;39;25;3023;3210
3173;12.05.2019;63;96;33;65;1934;2027
3174;20.06.2019;50;71;21;70;3667;2132
3175;04.06.2019;57;69;12;82;4218;1090
3176;21.02.2020;92;123;31;74;289;215
3177;11.07.2019;68;94;26;72;2129;2789
3178;22.09.2019;9;28;19;32;2165;2860
3179;02.06.2019;18;30;12;60;1424;3983
3180;14.09.2019;74;105;31;70;1734;221
3181;13.04.2019;24;64;40;37;930;1665
3182;23.10.2019;98;124;26;79;2057;2336
3183;11.10.2019;24;61;37;39;1207;4857
3184;11.06.2019;76;92;16;82;4533;396
3185;13.09.2019;20;46;26;43;1635;2699
3186;22.05.2019;46;70;24;65;2971;2505
3187;19.03.2020;8;28;20;28;4990;2838
3188;04.01.2020;53;83;30;63;1622;4133
3189;17.09.2019;23;30;7;76;4186;1163
3190;23.12.2019;10;41;31;24;1929;4558
3191;05.02.2020;6;22;16;27;176;4823
3192;20.12.2019;64;68;4;94;97;1731
3193;25.01.2020;50;55;5;90;1173;3982
3194;08.08.2019;56;59;3;94;3736;466
3195;09.01.2020;16;31;15;51;4610;4148
3196;24.08.2019;8;45;37;17;2028;3456
3197;10.03.2020;53;85;32;62;675;3463
3198;03.03.2020;70;91;21;76;1322;4719
3199;31.12.2019;25;37;12;67;4655;157
3200;27.05.2019;11;25;14;44;4730;2792
3201;19.12.2019;18;42;24;42;4979;4080
3202;30.04.2019;52;57;5;91;1878;2103
3203;05.08.2019;14;15;1;93;3713;2520
3204;06.12.2019;11;33;22;33;3242;2211
3205;20.11.2019;20;23;3;86;2724;3605
3206;16.03.2020;21;56;35;37;2839;1896
3207;04.12.2019;69;75;6;92;1006;4956
3208;28.04.2019;93;101;8;92;543;843
3209;01.09.2019;12;16;4;75;4417;3007
3210;21.02.2020;18;54;36;33;2686;2827
3211;29.07.2019;18;41;23;43;2861;194
3212;01.08.2019;65;78;13;83;1773;1737
3213;14.06.2019;97;132;35;73;2631;357
3214;18.01.2020;68;94;26;72;4599;4294
3215;06.02.2020;34;36;2;94;3384;2986
3216;17.04.2019;27;40;13;67;1350;914
3217;03.02.2020;30;61;31;49;2398;4021
3218;23.05.2019;38;46;8;82;1064;3778
3219;25.04.2019;61;76;15;80;4090;4867
3220;02.06.2019;55;82;27;67;4914;1229
3221;13.12.2019;62;67;5;92;287;1543
3222;17.02.2020;17;43;26;39;1445;2718
3223;04.11.2019;42;43;1;97;1403;4875
3224;01.02.2020;77;97;20;79;879;614
3225;25.08.2019;90;100;10;90;3915;2698
3226;04.12.2019;93;130;37;71;726;3744
3227;05.04.2019;45;46;1;97;1454;3763
3228;01.09.2019;7;25;18;28;2741;1033
3229;02.07.2019;10;30;20;33;71;601
3230;29.10.2019;79;112;33;70;3453;1737
3231;02.01.2020;70;108;38;64;412;2633
3232;30.10.2019;36;62;26;58;1674;1507
3233;03.09.2019;82;84;2;97;4322;4127
3234;23.09.2019;94;119;25;78;1481;2061
3235;09.06.2019;39;55;16;70;1857;3340
3236;18.09.2019;38;56;18;67;2561;1526
3237;16.06.2019;50;85;35;58;1253;4708
3238;16.10.2019;71;90;19;78;1178;1039
3239;03.07.2019;15;42;27;35;4374;3101
3240;04.07.2019;35;46;11;76;2857;3529
3241;14.10.2019;32;67;35;47;2428;2357
3242;26.06.2019;56;69;13;81;1160;3558
3243;23.11.2019;28;42;14;66;4813;1608
3244;20.01.2020;44;77;33;57;3335;4659
3245;06.02.2020;7;21;14;33;4962;3937
3246;04.06.2019;56;77;21;72;2093;3576
3247;12.11.2019;84;103;19;81;1777;1864
3248;07.11.2019;30;59;29;50;3397;3330
3249;17.08.2019;55;62;7;88;1619;3189
3250;05.09.2019;13;36;23;36;1446;578
3251;16.08.2019;48;73;25;65;2265;3786
3252;17.01.2020;91;99;8;91;1257;3755
3253;02.10.2019;42;79;37;53;3573;4285
3254;31.05.2019;19;43;24;44;102;2839
3255;09.06.2019;3;41;38;7;4489;3208
3256;30.12.2019;30;41;11;73;3087;2471
3257;24.11.2019;58;79;21;73;795;3698
3258;22.07.2019;83;109;26;76;4912;4466
3259;04.05.2019;28;54;26;51;3648;1909
3260;30.03.2019;74;109;35;67;3597;1709
3261;18.02.2020;44;45;1;97;279;732
3262;03.05.2019;5;45;40;11;2172;3483
3263;20.09.2019;80;113;33;70;3085;3945
3264;15.09.2019;40;41;1;97;221;2975
3265;06.10.2019;99;114;15;86;4262;3098
3266;02.05.2019;52;78;26;66;923;2914
3267;09.06.2019;63;83;20;75;3721;1038
3268;01.11.2019;50;55;5;90;3268;2336
3269;12.01.2020;100;118;18;84;4791;3955
3270;20.05.2019;24;61;37;39;3265;952
3271;03.04.2019;90;92;2;97;829;3230
3272;28.05.2019;86;103;17;83;4723;3293
3273;28.11.2019;48;52;4;92;4028;3504
3274;15.12.2019;100;135;35;74;798;4861
3275;09.03.2020;12;42;30;28;2257;383
3276;26.09.2019;23;32;9;71;1140;3309
3277;27.11.2019;42;55;13;76;1890;2373
3278;03.07.2019;13;41;28;31;2088;2249
3279;28.09.2019;60;73;13;82;4620;208
3280;15.03.2020;37;59;22;62;1038;1954
3281;13.01.2020;33;51;18;64;207;2260
3282;16.04.2019;98;99;1;98;773;588
3283;01.06.2019;35;43;8;81;2335;1201
3284;23.02.2020;97;119;22;81;801;1133
3285;05.03.2020;89;127;38;70;381;4314
3286;10.03.2020;12;21;9;57;1164;2367
3287;12.10.2019;71;78;7;91;2434;4541
3288;21.11.2019;55;61;6;90;1120;4424
3289;03.01.2020;82;92;10;89;2137;4482
3290;23.06.2019;68;91;23;74;1397;2028
3291;11.01.2020;70;78;8;89;4121;2096
3292;20.11.2019;43;59;16;72;805;3517
3293;29.02.2020;96;105;9;91;1696;70
3294;26.05.2019;19;37;18;51;338;4761
3295;24.01.2020;93;108;15;86;4531;1681
3296;25.01.2020;95;104;9;91;3598;445
3297;18.08.2019;75;109;34;68;487;2172
3298;10.08.2019;61;65;4;93;4164;2713
3299;26.10.2019;40;51;11;78;345;2519
3300;12.11.2019;11;50;39;22;4171;2771
3301;14.11.2019;68;97;29;70;296;3282
3302;24.07.2019;20;56;36;35;3866;4200
3303;25.07.2019;35;55;20;63;1627;3616
3304;08.02.2020;61;75;14;81;1820;1784
3305;24.01.2020;23;37;14;62;1979;561
3306;27.08.2019;100;107;7;93;2154;2535
3307;12.06.2019;84;89;5;94;4722;2059
3308;13.03.2020;7;22;15;31;3745;2634
3309;07.11.2019;100;116;16;86;3117;1932
3310;16.10.2019;47;86;39;54;169;4835
3311;10.03.2020;84;110;26;76;3182;4727
3312;26.06.2019;80;99;19;80;4870;2475
3313;29.12.2019;58;87;29;66;3707;2430
3314;21.04.2019;81;91;10;89;2120;918
3315;04.09.2019;11;27;16;40;294;2745
3316;16.09.2019;20;33;13;60;1563;4267
3317;04.12.2019;29;52;23;55;3587;3282
3318;13.06.2019;90;92;2;97;2872;1181
3319;20.05.2019;23;62;39;37;1876;2769
3320;18.11.2019;34;53;19;64;4517;3946
3321;18.08.2019;74;114;40;64;2354;3228
3322;08.03.2020;70;75;5;93;4859;598
3323;27.07.2019;14;47;33;29;4468;2322
3324;03.05.2019;14;50;36;28;2695;1295
3325;19.11.2019;22;43;21;51;236;486
3326;23.07.2019;74;88;14;84;4914;1264
3327;06.02.2020;45;82;37;54;1787;462
3328;05.09.2019;97;98;1;98;3010;763
3329;29.03.2019;61;96;35;63;2461;480
3330;06.10.2019;42;70;28;60;4385;2664
3331;01.09.2019;55;66;11;83;3885;3056
3332;31.08.2019;52;91;39;57;3447;72
3333;23.07.2019;40;73;33;54;1352;3915
3334;02.02.2020;21;57;36;36;2763;4638
3335;16.06.2019;76;89;13;85;3090;2598
3336;16.06.2019;30;62;32;48;1093;2993
3337;11.10.2019;36;41;5;87;2110;1649
3338;14.01.2020;25;41;16;60;1710;1712
3339;31.07.2019;55;88;33;62;193;3487
3340;30.01.2020;84;100;16;84;1379;2295
3341;30.01.2020;61;77;16;79;166;4680
3342;07.07.2019;56;93;37;60;573;4533
3343;09.10.2019;89;99;10;89;3142;4627
3344;16.09.2019;56;76;20;73;34;429
3345;25.04.2019;87;119;32;73;2217;2770
3346;25.08.2019;6;46;40;13;4474;3263
3347;24.04.2019;45;57;12;78;2467;4928
3348;23.01.2020;85;101;16;84;905;1684
3349;30.05.2019;52;59;7;88;2699;2180
3350;20.03.2020;5;40;35;12;2362;856
3351;27.09.2019;99;117;18;84;3782;1330
3352;16.02.2020;64;81;17;79;2238;1309
3353;01.11.2019;9;18;9;50;4347;3112
3354;29.11.2019;28;64;36;43;1112;4080
3355;14.12.2019;58;83;25;69;4468;3494
3356;24.02.2020;26;45;19;57;2326;4779
3357;30.09.2019;29;45;16;64;2583;3473
3358;07.08.2019;87;124;37;70;1733;2659
3359;18.11.2019;61;92;31;66;4384;2333
3360;21.01.2020;65;78;13;83;2445;2507
3361;17.04.2019;79;100;21;79;4998;4019
3362;16.01.2020;61;72;11;84;4013;3896
3363;26.07.2019;93;101;8;92;3832;2657
3364;29.01.2020;37;73;36;50;1870;3046
3365;11.10.2019;74;95;21;77;3505;3776
3366;01.04.2019;74;88;14;84;1623;3056
3367;04.01.2020;73;81;8;90;4326;3703
3368;09.05.2019;88;108;20;81;2172;865
3369;19.12.2019;31;67;36;46;23;3381
3370;11.02.2020;82;93;11;88;4409;602
3371;17.07.2019;16;27;11;59;3596;4336
3372;08.12.2019;47;54;7;87;3642;106
3373;25.04.2019;67;88;21;76;3851;1368
3374;18.06.2019;95;127;32;74;11;3135
3375;20.06.2019;2;16;14;12;571;1713
3376;22.09.2019;34;35;1;97;1977;2481
3377;27.08.2019;41;73;32;56;555;4101
3378;17.06.2019;93;121;28;76;3078;1520
3379;22.03.2020;10;26;16;38;4720;1472
3380;01.04.2019;83;119;36;69;4594;566
3381;20.09.2019;96;113;17;84;688;3430
3382;19.03.2020;37;49;12;75;4428;1244
3383;13.09.2019;61;68;7;89;124;1842
3384;01.05.2019;26;49;23;53;2045;49
3385;28.08.2019;98;134;36;73;1188;3843
3386;08.09.2019;43;51;8;84;517;554
3387;20.12.2019;15;21;6;71;733;328
3388;08.03.2020;59;82;23;71;373;68
3389;01.12.2019;42;66;24;63;4101;4273
3390;10.10.2019;19;31;12;61;871;824
3391;07.01.2020;68;76;8;89;1983;572
3392;05.02.2020;89;99;10;89;1258;4113
3393;20.11.2019;83;94;11;88;798;4360
3394;27.07.2019;8;23;15;34;1260;689
3395;28.05.2019;2;8;6;25;35;1499
3396;03.12.2019;57;90;33;63;3825;4281
3397;06.06.2019;29;43;14;67;1400;2182
3398;17.07.2019;11;26;15;42;1140;577
3399;16.11.2019;82;93;11;88;4762;3579
3400;18.05.2019;70;98;28;71;3069;1747
3401;21.01.2020;3;14;11;21;2789;1797
3402;01.12.2019;59;97;38;60;4698;574
3403;11.07.2019;78;101;23;77;2029;1077
3404;02.06.2019;78;117;39;66;594;2383
3405;07.08.2019;46;49;3;93;927;4398
3406;24.05.2019;22;53;31;41;2023;4883
3407;22.12.2019;26;45;19;57;3633;4321
3408;14.12.2019;2;27;25;7;437;1942
3409;23.04.2019;51;77;26;66;2377;4959
3410;07.01.2020;86;89;3;96;599;2484
3411;18.09.2019;55;91;36;60;551;2930
3412;30.04.2019;16;29;13;55;954;2572
3413;05.04.2019;92;96;4;95;2575;4151
3414;21.03.2020;64;82;18;78;3345;2823
3415;15.03.2020;41;76;35;53;2778;537
3416;14.06.2019;46;78;32;58;1350;692
3417;25.02.2020;82;88;6;93;4506;4475
3418;30.05.2019;76;98;22;77;4022;2687
3419;20.01.2020;97;136;39;71;1690;2690
3420;18.08.2019;60;73;13;82;2537;693
3421;14.09.2019;77;79;2;97;4199;3918
3422;04.05.2019;63;82;19;76;3483;4303
3423;09.03.2020;77;98;21;78;4535;2408
3424;17.10.2019;67;77;10;87;2981;1408
3425;30.08.2019;19;27;8;70;3829;1663
3426;19.12.2019;88;122;34;72;4867;1580
3427;13.06.2019;83;99;16;83;4416;2217
3428;19.11.2019;10;22;12;45;3823;4545
3429;24.03.2020;73;74;1;98;3951;4453
3430;24.07.2019;5;28;23;17;1080;4747
3431;16.10.2019;13;48;35;27;681;2172
3432;01.10.2019;45;76;31;59;4344;3239
3433;06.02.2020;81;84;3;96;2688;2940
3434;18.10.2019;15;39;24;38;714;2423
3435;25.03.2020;41;60;19;68;4568;1188
3436;05.01.2020;95;113;18;84;327;1657
3437;16.08.2019;49;89;40;55;3335;1974
3438;16.12.2019;85;119;34;71;4193;4531
3439;05.07.2019;6;41;35;14;3238;3618
3440;01.01.2020;81;114;33;71;3891;2747
3441;09.10.2019;59;65;6;90;4924;2498
3442;06.11.2019;78;105;27;74;1011;4316
3443;15.05.2019;2;16;14;12;604;4692
3444;19.09.2019;60;76;16;78;4341;756
3445;17.08.2019;63;81;18;77;4770;2884
3446;22.09.2019;88;92;4;95;3159;1315
3447;29.02.2020;41;44;3;93;529;4168
3448;15.10.2019;75;114;39;65;4863;207
3449;20.09.2019;6;20;14;30;323;4403
3450;04.12.2019;21;42;21;50;391;3895
3451;26.01.2020;43;78;35;55;3181;2728
3452;06.04.2019;71;107;36;66;1046;4514
3453;29.12.2019;15;18;3;83;1149;2082
3454;03.01.2020;43;54;11;79;4392;998
3455;22.08.2019;81;89;8;91;4019;781
3456;31.12.2019;5;20;15;25;881;4866
3457;03.06.2019;62;66;4;93;4254;4436
3458;08.03.2020;8;24;16;33;2384;1644
3459;02.11.2019;58;74;16;78;1095;1278
3460;27.01.2020;91;104;13;87;4094;1550
3461;22.10.2019;19;37;18;51;1103;4762
3462;19.06.2019;30;40;10;75;753;2973
3463;11.02.2020;49;51;2;96;3673;2302
3464;24.02.2020;49;65;16;75;4185;1359
3465;10.08.2019;1;4;3;25;420;834
3466;23.09.2019;88;93;5;94;1364;2080
3467;28.11.2019;19;27;8;70;4318;4291
3468;21.11.2019;91;129;38;70;2832;1964
3469;16.08.2019;55;56;1;98;2124;659
3470;07.03.2020;90;102;12;88;1622;563
3471;25.04.2019;69;109;40;63;3116;3725
3472;02.05.2019;23;50;27;46;4715;1204
3473;28.02.2020;60;97;37;61;290;2358
3474;14.07.2019;31;39;8;79;2787;4378
3475;28.06.2019;39;67;28;58;1135;2300
3476;18.06.2019;47;80;33;58;3514;249
3477;08.08.2019;63;79;16;79;1617;322
3478;23.06.2019;10;33;23;30;4575;1295
3479;01.04.2019;67;86;19;77;999;4241
3480;16.04.2019;75;112;37;66;704;4086
3481;22.04.2019;46;64;18;71;2488;1973
3482;02.11.2019;83;85;2;97;3107;1371
3483;05.07.2019;38;58;20;65;3375;617
3484;14.03.2020;78;110;32;70;3232;2603
3485;01.03.2020;4;38;34;10;802;3144
3486;02.09.2019;67;81;14;82;363;2977
3487;12.04.2019;84;106;22;79;2718;38
3488;18.10.2019;86;117;31;73;2983;2810
3489;11.04.2019;39;69;30;56;4590;3406
3490;01.06.2019;43;49;6;87;3641;1242
3491;21.04.2019;32;58;26;55;4995;4414
3492;15.12.2019;59;64;5;92;171;3490
3493;11.06.2019;86;106;20;81;844;1901
3494;23.01.2020;51;57;6;89;2572;3939
3495;26.01.2020;84;105;21;80;951;1085
3496;03.07.2019;7;30;23;23;158;2667
3497;28.11.2019;27;66;39;40;1716;2612
3498;17.09.2019;19;38;19;50;47;1467
3499;26.11.2019;16;17;1;94;651;3857
3500;02.06.2019;58;77;19;75;1673;4070
3501;23.01.2020;20;30;10;66;4478;752
3502;30.03.2019;51;76;25;67;2518;3992
3503;04.08.2019;79;98;19;80;1195;3972
3504;13.09.2019;65;78;13;83;1469;2986
3505;27.01.2020;34;44;10;77;1723;2657
3506;10.05.2019;30;64;34;46;480;784
3507;14.02.2020;7;35;28;20;3870;3357
3508;24.12.2019;21;33;12;63;785;3588
3509;17.12.2019;93;131;38;70;3122;1545
3510;19.07.2019;8;14;6;57;1151;1061
3511;16.06.2019;35;72;37;48;902;3338
3512;27.03.2020;83;96;13;86;1353;1691
3513;27.11.2019;90;127;37;70;3789;4939
3514;26.07.2019;28;37;9;75;4848;2451
3515;27.02.2020;65;86;21;75;30;2249
3516;27.03.2020;63;71;8;88;2131;4611
3517;17.05.2019;57;71;14;80;1567;1208
3518;12.12.2019;94;108;14;87;1993;1582
3519;14.04.2019;47;51;4;92;3685;1561
3520;27.06.2019;5;33;28;15;2358;597
3521;24.01.2020;49;77;28;63;750;560
3522;03.12.2019;84;115;31;73;2836;2836
3523;22.07.2019;33;52;19;63;2325;3388
3524;03.01.2020;36;68;32;52;3758;4377
3525;23.01.2020;94;106;12;88;681;2726
3526;31.03.2019;36;43;7;83;3251;13
3527;22.02.2020;53;54;1;98;3356;3757
3528;01.05.2019;27;59;32;45;2446;283
3529;23.12.2019;30;42;12;71;4178;3674
3530;24.02.2020;81;120;39;67;3692;4477
3531;31.05.2019;22;48;26;45;1822;4163
3532;10.09.2019;94;100;6;94;2979;3915
3533;20.03.2020;85;112;27;75;315;4290
3534;11.02.2020;35;48;13;72;2647;1403
3535;22.11.2019;8;33;25;24;4411;727
3536;21.04.2019;54;91;37;59;3520;897
3537;01.02.2020;81;105;24;77;4707;4170
3538;27.02.2020;50;72;22;69;2981;2197
3539;09.05.2019;18;25;7;72;2815;2862
3540;29.08.2019;92;102;10;90;1065;1668
3541;10.10.2019;68;81;13;83;2237;3161
3542;19.10.2019;98;138;40;71;4217;3842
3543;18.09.2019;9;49;40;18;3679;2669
3544;22.03.2020;71;74;3;95;1964;3724
3545;08.08.2019;81;87;6;93;839;2248
3546;23.09.2019;35;52;17;67;3279;3064
3547;13.05.2019;69;70;1;98;2326;3395
3548;13.05.2019;77;95;18;81;3396;3097
3549;10.06.2019;52;82;30;63;4480;592
3550;27.03.2020;35;60;25;58;489;420
3551;27.11.2019;47;62;15;75;4121;3547
3552;20.05.2019;78;81;3;96;1630;3202
3553;12.08.2019;58;66;8;87;4445;1545
3554;03.05.2019;5;15;10;33;4223;2853
3555;14.07.2019;25;60;35;41;1722;4953
3556;22.05.2019;5;10;5;50;2034;3939
3557;07.06.2019;75;90;15;83;42;798
3558;25.03.2020;1;38;37;2;2735;610
3559;03.08.2019;20;39;19;51;2087;4038
3560;27.11.2019;98;104;6;94;170;2342
3561;19.09.2019;77;100;23;77;4142;2581
3562;16.09.2019;55;74;19;74;3469;1163
3563;02.03.2020;70;76;6;92;4451;4897
3564;12.03.2020;35;62;27;56;461;1612
3565;27.04.2019;95;104;9;91;4698;4713
3566;18.09.2019;84;119;35;70;3795;1661
3567;12.08.2019;30;66;36;45;2595;136
3568;11.05.2019;75;109;34;68;3508;115
3569;24.09.2019;96;102;6;94;2710;4787
3570;26.03.2020;33;53;20;62;4480;4702
3571;24.02.2020;77;113;36;68;1423;1646
3572;15.01.2020;15;30;15;50;427;30
3573;09.07.2019;92;98;6;93;2887;1495
3574;03.04.2019;6;36;30;16;3209;4082
3575;08.05.2019;59;83;24;71;1005;2017
3576;22.05.2019;72;101;29;71;3525;2823
3577;06.08.2019;28;59;31;47;2283;4928
3578;31.08.2019;37;71;34;52;3600;1950
3579;11.01.2020;87;103;16;84;2329;1686
3580;10.01.2020;34;51;17;66;2837;1491
3581;13.01.2020;11;44;33;25;852;3681
3582;18.10.2019;59;69;10;85;2458;3306
3583;24.01.2020;32;50;18;64;1117;2716
3584;21.05.2019;18;38;20;47;1192;1483
3585;21.06.2019;24;42;18;57;265;2769
3586;23.09.2019;4;27;23;14;1103;888
3587;11.10.2019;19;33;14;57;1511;4366
3588;07.04.2019;31;44;13;70;3792;4322
3589;21.12.2019;48;59;11;81;3319;2644
3590;23.09.2019;66;100;34;66;565;1421
3591;21.07.2019;21;34;13;61;2222;2865
3592;28.08.2019;62;67;5;92;4171;1731
3593;14.10.2019;26;59;33;44;667;4836
3594;12.07.2019;94;96;2;97;2851;1266
3595;23.10.2019;2;18;16;11;879;82
3596;08.07.2019;50;70;20;71;1451;2914
3597;08.10.2019;39;70;31;55;4751;3560
3598;16.11.2019;23;42;19;54;3978;2356
3599;09.06.2019;88;91;3;96;4054;2251
3600;27.04.2019;62;72;10;86;2487;1726
3601;26.06.2019;10;19;9;52;2353;4908
3602;04.03.2020;49;67;18;73;3835;3375
3603;30.03.2019;10;19;9;52;2608;4720
3604;06.05.2019;68;74;6;91;2842;4154
3605;15.05.2019;44;80;36;55;4415;4455
3606;27.04.2019;17;26;9;65;4708;4622
3607;19.07.2019;65;80;15;81;606;1916
3608;19.03.2020;82;89;7;92;1304;349
3609;14.07.2019;83;123;40;67;2664;498
3610;21.10.2019;82;87;5;94;1914;3612
3611;19.04.2019;91;118;27;77;4820;2257
3612;22.06.2019;30;65;35;46;4224;3377
3613;05.04.2019;98;125;27;78;760;2923
3614;28.08.2019;98;122;24;80;3313;820
3615;12.01.2020;40;76;36;52;1256;101
3616;29.07.2019;71;83;12;85;3019;4193
3617;27.11.2019;71;98;27;72;2549;2971
3618;21.08.2019;85;91;6;93;3207;2961
3619;16.02.2020;64;75;11;85;3918;3309
3620;05.07.2019;20;44;24;45;3414;193
3621;04.04.2019;85;123;38;69;86;1772
3622;31.08.2019;79;108;29;73;4391;1945
3623;28.09.2019;73;103;30;70;354;60
3624;02.06.2019;25;40;15;62;3248;1899
3625;27.07.2019;8;35;27;22;3838;3343
3626;06.10.2019;93;125;32;74;2408;3737
3627;22.08.2019;46;83;37;55;2022;1582
3628;16.06.2019;30;52;22;57;4194;4973
3629;17.07.2019;95;100;5;95;4634;1705
3630;20.12.2019;72;75;3;96;211;4976
3631;30.12.2019;98;130;32;75;4193;3171
3632;10.06.2019;87;100;13;87;3049;1982
3633;02.06.2019;52;68;16;76;4436;4554
3634;30.08.2019;69;94;25;73;3753;3917
3635;26.06.2019;12;37;25;32;4867;2285
3636;02.09.2019;21;58;37;36;522;451
3637;07.07.2019;20;24;4;83;1788;1887
3638;18.01.2020;11;20;9;55;485;1564
3639;31.07.2019;81;95;14;85;2409;1418
3640;30.09.2019;1;30;29;3;3721;4583
3641;09.01.2020;67;99;32;67;3630;681
3642;12.05.2019;46;55;9;83;2871;572
3643;11.07.2019;86;89;3;96;3756;1080
3644;02.10.2019;18;52;34;34;2277;4436
3645;18.01.2020;5;34;29;14;378;2052
3646;23.03.2020;21;55;34;38;4536;3006
3647;18.10.2019;68;77;9;88;12;1369
3648;03.12.2019;42;67;25;62;674;209
3649;04.03.2020;12;18;6;66;1345;1283
3650;11.10.2019;81;101;20;80;2192;2501
3651;14.07.2019;95;127;32;74;3275;3297
3652;08.03.2020;86;103;17;83;4955;2323
3653;16.10.2019;40;78;38;51;69;2134
3654;05.04.2019;55;63;8;87;4189;957
3655;09.12.2019;96;124;28;77;2309;1857
3656;09.07.2019;85;100;15;85;1256;2968
3657;23.03.2020;8;37;29;21;3511;1571
3658;21.10.2019;94;107;13;87;2338;2474
3659;25.09.2019;48;76;28;63;2375;3008
3660;14.06.2019;34;73;39;46;4240;1190
3661;29.07.2019;73;81;8;90;2872;2626
3662;29.03.2019;16;44;28;36;1816;4773
3663;12.09.2019;64;99;35;64;222;4070
3664;15.02.2020;45;66;21;68;1286;1352
3665;02.06.2019;60;70;10;85;3493;3087
3666;03.01.2020;55;74;19;74;4091;2657
3667;25.10.2019;43;55;12;78;418;3478
3668;11.07.2019;31;54;23;57;4209;4036
3669;01.08.2019;82;86;4;95;3389;1898
3670;17.09.2019;12;20;8;60;3783;1147
3671;21.01.2020;62;102;40;60;2723;4834
3672;18.10.2019;26;30;4;86;3693;1293
3673;12.07.2019;97;111;14;87;3408;1550
3674;18.08.2019;25;32;7;78;1010;180
3675;06.07.2019;47;85;38;55;2076;2889
3676;08.05.2019;5;28;23;17;2144;1438
3677;11.09.2019;50;58;8;86;905;2503
3678;23.04.2019;2;15;13;13;3455;2436
3679;09.06.2019;12;43;31;27;910;2300
3680;19.03.2020;36;69;33;52;4319;3016
3681;19.11.2019;59;90;31;65;1298;3165
3682;02.09.2019;26;56;30;46;2933;2343
3683;21.09.2019;9;46;37;19;1677;3136
3684;03.01.2020;6;33;27;18;2554;741
3685;16.11.2019;54;55;1;98;4418;4672
3686;22.03.2020;35;40;5;87;2325;971
3687;03.10.2019;59;83;24;71;4583;3518
3688;17.10.2019;8;22;14;36;2022;4220
3689;23.12.2019;71;110;39;64;3260;1587
3690;16.01.2020;17;32;15;53;4986;483
3691;30.11.2019;62;76;14;81;2229;3008
3692;30.05.2019;41;69;28;59;1575;1982
3693;09.08.2019;20;57;37;35;205;3358
3694;12.05.2019;65;102;37;63;1921;4503
3695;08.11.2019;24;36;12;66;606;2009
3696;27.07.2019;38;77;39;49;4872;4459
3697;23.02.2020;6;10;4;60;4279;3901
3698;21.10.2019;67;92;25;72;2085;1003
3699;17.02.2020;5;16;11;31;225;4075
3700;24.06.2019;6;31;25;19;184;219
3701;15.05.2019;67;86;19;77;1315;18
3702;05.03.2020;50;90;40;55;1117;1947
3703;26.10.2019;42;67;25;62;3767;132
3704;07.08.2019;33;45;12;73;4577;3251
3705;18.10.2019;63;71;8;88;2681;850
3706;08.01.2020;14;44;30;31;93;1938
3707;15.04.2019;54;74;20;72;3224;4432
3708;17.06.2019;41;63;22;65;2524;2120
3709;01.06.2019;50;74;24;67;735;1539
3710;31.12.2019;3;20;17;15;262;681
3711;28.09.2019;34;44;10;77;4994;2624
3712;12.05.2019;70;74;4;94;647;1990
3713;27.12.2019;87;107;20;81;2604;396
3714;01.12.2019;24;52;28;46;1804;2912
3715;24.05.2019;20;28;8;71;3667;3555
3716;07.01.2020;26;28;2;92;1539;679
3717;30.08.2019;53;89;36;59;204;481
3718;11.03.2020;78;94;16;82;1083;3729
3719;18.03.2020;25;47;22;53;634;4907
3720;07.01.2020;80;116;36;68;942;827
3721;21.07.2019;16;28;12;57;2329;4380
3722;23.09.2019;27;44;17;61;3455;474
3723;03.05.2019;99;136;37;72;3716;2646
3724;07.07.2019;20;27;7;74;3214;3516
3725;05.02.2020;76;95;19;80;3521;1725
3726;25.11.2019;46;54;8;85;1603;2113
3727;04.01.2020;22;49;27;44;3473;4647
3728;09.05.2019;15;34;19;44;4709;834
3729;25.08.2019;10;31;21;32;2337;311
3730;04.09.2019;95;122;27;77;3837;1318
3731;04.04.2019;92;96;4;95;2890;3743
3732;29.05.2019;42;43;1;97;2919;1306
3733;28.04.2019;14;19;5;73;2432;841
3734;04.02.2020;9;41;32;21;387;3733
3735;04.05.2019;63;66;3;95;4298;82
3736;03.08.2019;40;65;25;61;2761;2300
3737;12.09.2019;19;43;24;44;3897;4124
3738;23.05.2019;29;46;17;63;4430;4183
3739;23.11.2019;91;106;15;85;419;906
3740;27.07.2019;47;78;31;60;2732;2431
3741;12.07.2019;72;111;39;64;3038;4279
3742;24.10.2019;39;76;37;51;1593;876
3743;08.07.2019;93;115;22;80;2768;537
3744;11.10.2019;61;68;7;89;4688;997
3745;09.12.2019;42;74;32;56;2307;344
3746;13.04.2019;44;70;26;62;627;1670
3747;02.04.2019;86;98;12;87;1678;2806
3748;22.04.2019;14;52;38;26;2606;2869
3749;28.08.2019;35;62;27;56;2271;447
3750;15.04.2019;64;80;16;80;3232;4671
3751;14.06.2019;40;74;34;54;2125;3959
3752;24.06.2019;63;102;39;61;2885;3065
3753;17.02.2020;27;38;11;71;2904;4892
3754;07.12.2019;44;71;27;61;4451;3587
3755;01.12.2019;99;136;37;72;1815;2454
3756;08.07.2019;85;93;8;91;2649;31
3757;29.06.2019;98;129;31;75;2412;2853
3758;25.06.2019;30;68;38;44;4832;3656
3759;17.01.2020;23;52;29;44;374;4602
3760;04.12.2019;50;86;36;58;3659;4140
3761;21.09.2019;67;92;25;72;2690;3009
3762;22.07.2019;55;63;8;87;1429;2345
3763;20.04.2019;79;107;28;73;1534;4999
3764;11.07.2019;82;119;37;68;2813;839
3765;26.04.2019;93;103;10;90;1867;2730
3766;14.10.2019;15;37;22;40;3005;2735
3767;18.07.2019;86;87;1;98;1428;2148
3768;21.09.2019;87;108;21;80;4631;1992
3769;11.11.2019;88;118;30;74;2939;484
3770;14.01.2020;15;28;13;53;859;3436
3771;31.07.2019;60;95;35;63;2547;3627
3772;20.02.2020;98;128;30;76;4079;2133
3773;25.05.2019;58;72;14;80;2383;2783
3774;06.10.2019;12;27;15;44;4624;4633
3775;08.12.2019;88;109;21;80;2205;2017
3776;07.07.2019;91;116;25;78;4028;4291
3777;15.07.2019;15;35;20;42;4262;4409
3778;25.10.2019;36;46;10;78;1368;872
3779;13.08.2019;8;14;6;57;2559;4842
3780;22.01.2020;9;33;24;27;3237;4769
3781;25.07.2019;44;62;18;70;4282;127
3782;17.07.2019;99;118;19;83;521;549
3783;23.11.2019;56;93;37;60;3497;2966
3784;01.09.2019;73;102;29;71;4668;1798
3785;11.12.2019;20;43;23;46;4060;4607
3786;22.09.2019;10;35;25;28;4028;3969
3787;07.02.2020;43;58;15;74;1522;3893
3788;21.04.2019;12;34;22;35;3208;1116
3789;18.10.2019;36;71;35;50;4274;2447
3790;20.11.2019;57;59;2;96;707;4955
3791;21.08.2019;6;23;17;26;2509;520
3792;12.09.2019;81;94;13;86;3387;1308
3793;05.09.2019;58;98;40;59;4826;414
3794;02.03.2020;64;88;24;72;1112;3750
3795;05.12.2019;60;70;10;85;2368;2382
3796;17.09.2019;65;72;7;90;1475;1568
3797;21.08.2019;100;126;26;79;1687;1327
3798;24.07.2019;98;120;22;81;4661;1688
3799;19.08.2019;70;75;5;93;4884;2989
3800;06.08.2019;45;62;17;72;4745;419
3801;22.08.2019;4;44;40;9;3390;422
3802;19.09.2019;90;109;19;82;4450;1296
3803;27.12.2019;34;65;31;52;3747;4563
3804;23.02.2020;90;126;36;71;795;819
3805;01.09.2019;11;33;22;33;4138;1074
3806;31.10.2019;66;89;23;74;3556;4479
3807;18.06.2019;47;69;22;68;2339;3962
3808;15.03.2020;67;99;32;67;2102;4344
3809;24.08.2019;97;115;18;84;4834;2307
3810;12.12.2019;7;33;26;21;3006;886
3811;21.02.2020;35;75;40;46;1845;3215
3812;15.05.2019;85;95;10;89;199;1040
3813;23.05.2019;5;34;29;14;4196;2896
3814;19.10.2019;91;111;20;81;2965;4175
3815;15.08.2019;51;79;28;64;4805;3047
3816;16.10.2019;2;6;4;33;4618;3159
3817;05.07.2019;18;35;17;51;493;3254
3818;05.04.2019;33;73;40;45;2147;1832
3819;10.11.2019;85;96;11;88;830;3940
3820;22.02.2020;26;53;27;49;2138;2052
3821;08.09.2019;26;32;6;81;4836;1041
3822;11.11.2019;6;16;10;37;1904;2730
3823;08.06.2019;23;45;22;51;1593;4403
3824;30.12.2019;67;73;6;91;1978;2377
3825;24.03.2020;69;96;27;71;195;1307
3826;03.03.2020;96;121;25;79;3495;2206
3827;07.11.2019;17;46;29;36;1959;4589
3828;18.12.2019;13;40;27;32;2563;1505
3829;03.01.2020;86;92;6;93;2443;2618
3830;22.04.2019;53;66;13;80;2899;3882
3831;24.10.2019;48;55;7;87;1380;3028
3832;23.03.2020;73;88;15;82;3772;3488
3833;14.11.2019;78;86;8;90;1877;4243
3834;14.01.2020;5;17;12;29;3655;1456
3835;10.08.2019;46;86;40;53;2786;2746
3836;26.09.2019;87;92;5;94;4072;152
3837;05.05.2019;3;23;20;13;3384;1108
3838;26.01.2020;2;10;8;20;3758;2027
3839;23.11.2019;28;53;25;52;3534;3380
3840;26.09.2019;52;73;21;71;312;4134
3841;10.03.2020;49;73;24;67;4131;4483
3842;04.04.2019;23;31;8;74;1516;40
3843;26.04.2019;7;41;34;17;3877;3742
3844;24.09.2019;63;90;27;70;1322;4223
3845;23.03.2020;83;122;39;68;2163;2256
3846;02.11.2019;87;104;17;83;3308;1329
3847;25.02.2020;9;17;8;52;1976;1408
3848;13.11.2019;100;118;18;84;4770;1352
3849;23.08.2019;86;120;34;71;4200;1163
3850;24.10.2019;23;41;18;56;76;3531
3851;01.09.2019;20;48;28;41;4266;1329
3852;06.08.2019;98;123;25;79;2350;4197
3853;10.01.2020;42;63;21;66;1758;562
3854;04.01.2020;3;18;15;16;3546;3637
3855;24.04.2019;62;92;30;67;2009;4418
3856;22.02.2020;8;40;32;20;1798;878
3857;20.11.2019;37;66;29;56;3304;103
3858;08.03.2020;15;30;15;50;3796;2576
3859;21.10.2019;25;44;19;56;2047;3291
3860;05.12.2019;97;121;24;80;4408;57
3861;22.10.2019;13;25;12;52;3361;2497
3862;05.04.2019;71;90;19;78;2627;2792
3863;02.05.2019;63;102;39;61;3409;3787
3864;16.01.2020;45;69;24;65;3509;4832
3865;07.05.2019;15;44;29;34;4967;638
3866;05.10.2019;56;66;10;84;4484;94
3867;15.03.2020;70;97;27;72;2881;4912
3868;05.05.2019;23;45;22;51;433;4935
3869;03.06.2019;38;44;6;86;1885;3987
3870;23.11.2019;79;81;2;97;3719;284
3871;02.02.2020;92;102;10;90;920;506
3872;11.07.2019;15;49;34;30;568;2761
3873;01.10.2019;56;69;13;81;4067;1293
3874;27.09.2019;8;25;17;32;4543;4345
3875;07.10.2019;63;70;7;90;3904;3133
3876;02.04.2019;87;117;30;74;1358;3366
3877;24.04.2019;19;31;12;61;4503;533
3878;18.09.2019;5;22;17;22;3715;4186
3879;11.06.2019;56;95;39;58;555;25
3880;20.02.2020;79;111;32;71;2389;1599
3881;11.11.2019;67;89;22;75;3898;1572
3882;09.10.2019;97;100;3;97;354;71
3883;21.08.2019;8;13;5;61;3474;318
3884;05.02.2020;93;113;20;82;375;3598
3885;26.06.2019;39;65;26;60;153;3264
3886;23.02.2020;86;117;31;73;3865;86
3887;02.10.2019;63;90;27;70;761;532
3888;19.04.2019;65;67;2;97;3821;2696
3889;03.07.2019;54;82;28;65;4803;3292
3890;05.07.2019;18;44;26;40;3928;3550
3891;10.03.2020;77;80;3;96;1134;2948
3892;21.03.2020;18;25;7;72;3340;2095
3893;12.07.2019;60;66;6;90;2562;4739
3894;15.02.2020;74;84;10;88;4021;4567
3895;22.02.2020;14;48;34;29;3703;489
3896;06.05.2019;1;33;32;3;4666;2758
3897;19.08.2019;1;10;9;10;2104;4758
3898;12.01.2020;83;100;17;83;4103;4990
3899;20.07.2019;93;98;5;94;478;3290
3900;08.05.2019;74;111;37;66;2115;1940
3901;12.04.2019;46;79;33;58;3419;3014
3902;21.02.2020;78;94;16;82;4907;2410
3903;21.08.2019;89;127;38;70;2463;3134
3904;23.12.2019;46;76;30;60;2282;4090
3905;14.02.2020;94;113;19;83;959;3230
3906;05.09.2019;63;95;32;66;2564;2861
3907;08.01.2020;54;94;40;57;561;4534
3908;05.11.2019;88;124;36;70;1932;2739
3909;28.04.2019;23;40;17;57;3106;3879
3910;01.03.2020;92;122;30;75;1864;2982
3911;02.11.2019;25;40;15;62;3898;245
3912;23.06.2019;41;52;11;78;4234;3595
3913;12.03.2020;36;72;36;50;4772;574
3914;13.04.2019;31;68;37;45;245;300
3915;22.06.2019;28;64;36;43;2252;3104
3916;05.09.2019;42;78;36;53;4976;2431
3917;05.08.2019;6;14;8;42;4290;1582
3918;04.12.2019;13;31;18;41;155;37
3919;19.12.2019;58;73;15;79;1220;80
3920;19.01.2020;11;26;15;42;4577;3866
3921;21.01.2020;31;66;35;46;1926;1286
3922;09.10.2019;100;103;3;97;1081;2401
3923;10.11.2019;31;53;22;58;345;3717
3924;09.09.2019;44;59;15;74;657;106
3925;22.11.2019;44;76;32;57;334;63
3926;25.10.2019;63;80;17;78;241;3649
3927;20.02.2020;58;93;35;62;2745;547
3928;26.01.2020;15;38;23;39;2523;3755
3929;25.10.2019;92;119;27;77;368;944
3930;03.04.2019;9;12;3;75;3808;1034
3931;29.11.2019;8;23;15;34;3038;1692
3932;24.05.2019;81;120;39;67;3533;3048
3933;15.06.2019;98;114;16;85;3639;3242
3934;14.07.2019;64;79;15;81;3022;3233
3935;26.07.2019;24;32;8;75;1524;886
3936;08.07.2019;7;11;4;63;4766;4504
3937;26.09.2019;29;58;29;50;2317;4007
3938;29.01.2020;98;99;1;98;4571;252
3939;20.02.2020;55;78;23;70;608;421
3940;01.10.2019;66;84;18;78;256;3464
3941;29.02.2020;88;116;28;75;3264;4190
3942;08.10.2019;100;107;7;93;4555;4929
3943;28.02.2020;58;85;27;68;1673;979
3944;28.06.2019;78;108;30;72;2353;1206
3945;19.06.2019;37;57;20;64;490;752
3946;12.03.2020;98;108;10;90;3298;4721
3947;27.04.2019;29;50;21;58;313;3571
3948;16.10.2019;47;75;28;62;2894;4619
3949;05.04.2019;61;101;40;60;4394;1686
3950;09.11.2019;55;70;15;78;3105;1503
3951;23.08.2019;28;55;27;50;1681;337
3952;28.03.2020;70;82;12;85;3309;4159
3953;22.06.2019;4;5;1;80;1767;3093
3954;11.09.2019;24;31;7;77;618;1464
3955;18.11.2019;28;61;33;45;3508;1067
3956;09.05.2019;10;12;2;83;831;4141
3957;28.04.2019;94;103;9;91;4166;1987
3958;29.06.2019;4;19;15;21;2259;1793
3959;10.03.2020;47;64;17;73;826;2691
3960;21.01.2020;80;100;20;80;1379;1170
3961;20.07.2019;70;75;5;93;1795;970
3962;08.07.2019;18;19;1;94;1803;4676
3963;09.08.2019;2;21;19;9;363;2376
3964;20.07.2019;21;47;26;44;2406;2783
3965;22.02.2020;8;14;6;57;1457;169
3966;22.02.2020;99;118;19;83;1994;2752
3967;09.10.2019;2;30;28;6;1777;4368
3968;26.06.2019;59;94;35;62;1922;1825
3969;20.11.2019;58;70;12;82;1233;1933
3970;15.05.2019;86;104;18;82;536;2665
3971;19.11.2019;54;67;13;80;4702;2662
3972;05.06.2019;64;77;13;83;1950;4324
3973;28.10.2019;48;88;40;54;848;1266
3974;07.11.2019;46;71;25;64;2225;73
3975;25.11.2019;68;95;27;71;4294;2874
3976;01.09.2019;37;41;4;90;2910;2354
3977;07.05.2019;10;25;15;40;3820;2717
3978;02.09.2019;47;56;9;83;3849;745
3979;25.01.2020;32;62;30;51;579;3027
3980;24.02.2020;11;19;8;57;3201;1702
3981;16.06.2019;32;34;2;94;3842;4180
3982;19.08.2019;7;32;25;21;3657;3538
3983;22.09.2019;64;76;12;84;81;4932
3984;11.11.2019;55;74;19;74;1762;443
3985;03.09.2019;99;107;8;92;2528;939
3986;30.03.2019;57;77;20;74;3909;894
3987;19.05.2019;98;125;27;78;1241;1141
3988;19.12.2019;81;103;22;78;911;4347
3989;04.11.2019;18;28;10;64;4097;4029
3990;01.12.2019;13;20;7;65;2357;573
3991;14.09.2019;38;69;31;55;4267;1266
3992;01.12.2019;78;90;12;86;1793;40
3993;14.01.2020;21;27;6;77;3117;3620
3994;25.10.2019;38;44;6;86;2648;2223
3995;05.03.2020;51;90;39;56;4524;519
3996;22.11.2019;19;58;39;32;3516;1455
3997;29.01.2020;77;84;7;91;2894;3639
3998;02.06.2019;1;17;16;5;389;227
3999;07.08.2019;20;44;24;45;2385;4789
4000;12.07.2019;37;75;38;49;2330;3091
4001;20.03.2020;96;97;1;98;1881;1356
4002;04.11.2019;55;75;20;73;4469;3424
4003;12.04.2019;70;106;36;66;805;2067
4004;20.08.2019;13;32;19;40;2342;2633
4005;03.09.2019;55;85;30;64;808;41
4006;15.07.2019;25;44;19;56;2018;2668
4007;15.07.2019;11;51;40;21;472;1083
4008;21.07.2019;30;32;2;93;2026;3239
4009;07.08.2019;86;98;12;87;2636;3767
4010;20.01.2020;64;100;36;64;1864;4687
4011;08.06.2019;49;61;12;80;735;2838
4012;05.10.2019;59;65;6;90;1986;3855
4013;30.05.2019;79;96;17;82;4162;2054
4014;24.07.2019;24;40;16;60;600;4631
4015;24.12.2019;64;72;8;88;2679;2776
4016;28.05.2019;49;79;30;62;2991;521
4017;15.03.2020;58;83;25;69;2021;501
4018;13.03.2020;18;27;9;66;3861;2971
4019;16.08.2019;10;28;18;35;3972;156
4020;22.01.2020;10;47;37;21;3833;2377
4021;26.10.2019;31;50;19;62;879;2431
4022;22.01.2020;15;46;31;32;62;1298
4023;08.08.2019;76;107;31;71;3844;1042
4024;27.02.2020;41;60;19;68;3746;4169
4025;05.05.2019;22;37;15;59;2065;4220
4026;14.08.2019;61;97;36;62;660;869
4027;04.08.2019;15;19;4;78;629;264
4028;07.05.2019;29;34;5;85;1293;3252
4029;28.03.2020;98;133;35;73;175;4531
4030;26.11.2019;5;28;23;17;586;495
4031;23.03.2020;55;70;15;78;4269;2841
4032;22.03.2020;95;115;20;82;3199;3554
4033;18.11.2019;20;58;38;34;779;4395
4034;06.05.2019;23;32;9;71;3486;2582
4035;08.06.2019;39;46;7;84;1602;4600
4036;24.08.2019;31;38;7;81;1076;2095
4037;16.08.2019;32;44;12;72;3709;4646
4038;19.11.2019;68;87;19;78;2945;1411
4039;15.07.2019;83;113;30;73;4365;1190
4040;05.07.2019;24;54;30;44;2391;692
4041;25.02.2020;48;55;7;87;1235;2454
4042;17.10.2019;24;25;1;96;2879;480
4043;02.09.2019;79;87;8;90;4140;3227
4044;01.10.2019;24;26;2;92;3069;4542
4045;12.05.2019;69;80;11;86;3192;603
4046;04.04.2019;11;35;24;31;1921;868
4047;26.04.2019;6;14;8;42;2535;786
4048;21.06.2019;52;72;20;72;1036;3985
4049;06.06.2019;91;124;33;73;1169;2217
4050;06.11.2019;19;57;38;33;1282;4506
4051;14.04.2019;48;77;29;62;818;3440
4052;15.01.2020;55;69;14;79;1618;3300
4053;17.03.2020;57;62;5;91;601;4991
4054;02.12.2019;2;3;1;66;2916;3525
4055;04.03.2020;23;63;40;36;4299;1507
4056;10.10.2019;57;94;37;60;2746;4331
4057;26.08.2019;37;77;40;48;1169;3833
4058;16.10.2019;15;54;39;27;3721;4297
4059;06.12.2019;96;120;24;80;2;3698
4060;13.12.2019;19;37;18;51;2415;2195
4061;03.07.2019;16;47;31;34;1362;2017
4062;25.04.2019;10;39;29;25;3737;855
4063;16.09.2019;8;10;2;80;4156;2669
4064;09.05.2019;77;116;39;66;1263;1542
4065;13.04.2019;48;61;13;78;1178;4713
4066;10.12.2019;87;118;31;73;3628;4394
4067;27.08.2019;24;63;39;38;936;3785
4068;31.01.2020;94;100;6;94;2021;3149
4069;29.04.2019;3;19;16;15;2691;3966
4070;30.01.2020;97;122;25;79;4443;3441
4071;01.04.2019;80;113;33;70;1076;272
4072;09.06.2019;41;60;19;68;416;454
4073;28.08.2019;70;108;38;64;3129;2399
4074;08.07.2019;100;103;3;97;431;2824
4075;18.03.2020;50;69;19;72;3424;1115
4076;22.03.2020;43;82;39;52;660;4292
4077;10.11.2019;64;87;23;73;1112;659
4078;31.10.2019;22;39;17;56;2102;62
4079;29.04.2019;26;32;6;81;343;3239
4080;11.01.2020;87;109;22;79;2603;2170
4081;18.08.2019;100;140;40;71;1881;3207
4082;29.11.2019;43;58;15;74;631;4467
4083;01.05.2019;9;29;20;31;572;2390
4084;31.12.2019;1;18;17;5;1462;839
4085;14.05.2019;55;76;21;72;4724;4628
4086;14.05.2019;8;21;13;38;570;215
4087;08.12.2019;77;92;15;83;452;3265
4088;28.08.2019;81;96;15;84;655;1937
4089;19.01.2020;47;71;24;66;2498;4307
4090;19.02.2020;25;64;39;39;4059;4693
4091;30.03.2019;72;102;30;70;1845;3823
4092;05.01.2020;69;89;20;77;2032;4237
4093;30.10.2019;90;129;39;69;4442;1962
4094;27.03.2020;46;73;27;63;4968;3739
4095;13.11.2019;20;58;38;34;4626;1901
4096;28.08.2019;62;86;24;72;554;3787
4097;29.08.2019;21;27;6;77;2513;3127
4098;15.10.2019;36;60;24;60;3665;2509
4099;06.07.2019;96;122;26;78;3783;3532
4100;12.09.2019;78;99;21;78;3965;946
4101;28.04.2019;26;48;22;54;1254;3903
4102;26.05.2019;14;53;39;26;1605;1118
4103;17.02.2020;86;111;25;77;2366;4678
4104;29.09.2019;8;45;37;17;4942;2428
4105;29.09.2019;46;75;29;61;2566;4772
4106;06.02.2020;77;87;10;88;2512;3689
4107;25.05.2019;25;38;13;65;469;901
4108;13.12.2019;69;74;5;93;1097;66
4109;17.07.2019;1;21;20;4;2064;1885
4110;25.09.2019;89;106;17;83;3490;3958
4111;04.02.2020;25;38;13;65;1093;597
4112;29.02.2020;28;37;9;75;4144;2714
4113;06.05.2019;45;81;36;55;1550;1518
4114;05.12.2019;37;57;20;64;1067;4442
4115;27.07.2019;42;74;32;56;1981;4318
4116;24.07.2019;11;42;31;26;4534;679
4117;23.03.2020;88;106;18;83;2171;1853
4118;07.09.2019;76;93;17;81;1180;4496
4119;31.01.2020;78;108;30;72;4008;961
4120;16.07.2019;78;113;35;69;318;325
4121;01.04.2019;32;48;16;66;282;3022
4122;29.02.2020;85;123;38;69;4081;3678
4123;21.08.2019;82;122;40;67;569;4244
4124;11.03.2020;56;92;36;60;249;2468
4125;28.01.2020;9;22;13;40;1032;3063
4126;09.12.2019;79;80;1;98;324;4734
4127;08.11.2019;63;75;12;84;3921;995
4128;22.03.2020;89;111;22;80;2177;35
4129;10.07.2019;11;46;35;23;2589;952
4130;24.02.2020;83;121;38;68;4951;2764
4131;19.05.2019;99;107;8;92;4736;1901
4132;03.08.2019;49;89;40;55;4213;4626
4133;11.04.2019;60;78;18;76;3499;4647
4134;26.03.2020;82;92;10;89;2688;4813
4135;23.02.2020;80;118;38;67;3752;2379
4136;31.12.2019;38;58;20;65;2619;2358
4137;27.02.2020;81;84;3;96;4524;2969
4138;12.03.2020;6;9;3;66;1523;2624
4139;29.08.2019;62;77;15;80;2906;1356
4140;08.07.2019;17;56;39;30;15;4993
4141;12.03.2020;27;54;27;50;1916;3898
4142;09.07.2019;72;109;37;66;623;1364
4143;19.12.2019;32;45;13;71;3142;3528
4144;04.12.2019;59;79;20;74;4984;1130
4145;06.05.2019;41;80;39;51;44;437
4146;13.06.2019;19;42;23;45;384;557
4147;02.10.2019;88;93;5;94;3301;4815
4148;20.12.2019;89;117;28;76;808;2346
4149;22.11.2019;92;128;36;71;1679;2379
4150;21.02.2020;23;55;32;41;2496;443
4151;07.01.2020;56;62;6;90;2449;561
4152;13.11.2019;3;37;34;8;1754;3312
4153;24.02.2020;98;102;4;96;2057;2628
4154;01.12.2019;36;55;19;65;4164;4289
4155;02.11.2019;14;21;7;66;1730;2578
4156;25.10.2019;56;62;6;90;4911;4274
4157;03.03.2020;60;92;32;65;3489;933
4158;16.02.2020;37;64;27;57;380;4736
4159;21.12.2019;3;14;11;21;4714;3066
4160;04.10.2019;36;60;24;60;1917;4842
4161;13.10.2019;23;41;18;56;2597;2120
4162;11.09.2019;5;6;1;83;1002;1022
4163;23.09.2019;82;122;40;67;3478;1630
4164;21.06.2019;89;92;3;96;1810;679
4165;03.03.2020;30;34;4;88;955;4912
4166;05.03.2020;76;96;20;79;168;618
4167;31.12.2019;63;80;17;78;2305;587
4168;28.10.2019;54;66;12;81;2707;729
4169;30.06.2019;54;62;8;87;4977;1309
4170;17.10.2019;91;103;12;88;381;4689
4171;30.03.2019;58;73;15;79;2175;307
4172;15.08.2019;39;54;15;72;1387;4970
4173;19.07.2019;73;103;30;70;576;2453
4174;06.11.2019;15;29;14;51;3396;3262
4175;14.02.2020;93;126;33;73;1395;2964
4176;25.09.2019;9;47;38;19;3265;340
4177;28.02.2020;62;91;29;68;721;2824
4178;16.03.2020;92;113;21;81;270;534
4179;06.12.2019;39;68;29;57;3773;3256
4180;03.02.2020;83;85;2;97;298;228
4181;27.10.2019;59;98;39;60;4273;4085
4182;15.02.2020;58;75;17;77;4503;4819
4183;09.01.2020;51;72;21;70;2699;4160
4184;17.01.2020;16;32;16;50;4412;3925
4185;28.09.2019;97;117;20;82;3923;584
4186;14.01.2020;37;72;35;51;3746;764
4187;04.07.2019;85;117;32;72;817;2395
4188;18.03.2020;2;34;32;5;3114;3236
4189;01.04.2019;73;95;22;76;927;1471
4190;14.06.2019;44;78;34;56;3863;2829
4191;15.11.2019;92;123;31;74;181;2449
4192;24.05.2019;69;101;32;68;659;3585
4193;23.08.2019;82;106;24;77;1015;1479
4194;01.11.2019;53;68;15;77;2736;3453
4195;10.02.2020;20;30;10;66;2455;3235
4196;12.08.2019;88;118;30;74;3223;3530
4197;29.12.2019;23;46;23;50;4329;4403
4198;08.06.2019;7;21;14;33;2676;3712
4199;13.06.2019;8;10;2;80;2128;648
4200;19.10.2019;10;29;19;34;4598;4156
4201;16.09.2019;61;99;38;61;2546;3943
4202;12.11.2019;20;51;31;39;3854;623
4203;12.07.2019;78;115;37;67;3744;3723
4204;19.05.2019;97;122;25;79;4655;1143
4205;22.08.2019;85;95;10;89;3554;3821
4206;25.12.2019;14;15;1;93;3406;322
4207;10.03.2020;83;118;35;70;1864;1277
4208;11.02.2020;88;120;32;73;1417;396
4209;30.05.2019;86;98;12;87;649;3559
4210;29.04.2019;35;41;6;85;1579;4549
4211;12.11.2019;84;108;24;77;3469;3573
4212;30.06.2019;32;58;26;55;3641;357
4213;20.06.2019;33;49;16;67;2796;1352
4214;17.11.2019;13;51;38;25;1931;2336
4215;02.05.2019;24;62;38;38;4801;4235
4216;12.07.2019;64;74;10;86;36;4749
4217;11.10.2019;13;48;35;27;1711;582
4218;12.01.2020;96;109;13;88;1811;3148
4219;07.03.2020;32;48;16;66;4125;2237
4220;01.10.2019;30;47;17;63;3070;1092
4221;06.01.2020;22;62;40;35;2326;18
4222;29.11.2019;96;117;21;82;3812;1932
4223;31.01.2020;48;65;17;73;4731;1327
4224;13.07.2019;85;125;40;68;1820;3977
4225;03.09.2019;91;123;32;73;2048;4908
4226;14.08.2019;12;27;15;44;2339;2922
4227;19.10.2019;66;97;31;68;3552;45
4228;05.12.2019;80;112;32;71;2779;1317
4229;29.11.2019;88;96;8;91;2210;3499
4230;26.10.2019;35;47;12;74;3775;4543
4231;14.11.2019;46;60;14;76;1281;889
4232;02.01.2020;32;68;36;47;641;2013
4233;21.03.2020;26;51;25;50;4682;899
4234;30.03.2019;43;53;10;81;4691;1748
4235;08.11.2019;7;37;30;18;3618;1548
4236;19.04.2019;93;125;32;74;4543;764
4237;17.11.2019;50;51;1;98;355;1238
4238;22.12.2019;35;55;20;63;2655;2523
4239;01.02.2020;60;62;2;96;2419;4041
4240;02.05.2019;36;64;28;56;1860;4387
4241;13.12.2019;56;93;37;60;2818;1528
4242;19.11.2019;76;108;32;70;2710;4150
4243;23.09.2019;5;18;13;27;1157;2576
4244;24.11.2019;70;79;9;88;2399;2082
4245;07.02.2020;86;100;14;86;3862;3797
4246;04.08.2019;38;55;17;69;869;4773
4247;28.09.2019;78;91;13;85;356;3188
4248;16.11.2019;13;39;26;33;2164;4056
4249;17.01.2020;47;58;11;81;1495;581
4250;25.06.2019;9;10;1;90;1939;2162
4251;09.02.2020;25;33;8;75;2804;1321
4252;14.01.2020;28;65;37;43;2554;4633
4253;03.12.2019;91;113;22;80;2255;972
4254;08.08.2019;94;131;37;71;1280;4068
4255;05.09.2019;25;50;25;50;2729;2151
4256;02.01.2020;73;78;5;93;4156;1082
4257;15.02.2020;14;40;26;35;4310;2231
4258;15.04.2019;31;38;7;81;4574;2220
4259;19.11.2019;45;82;37;54;2022;581
4260;08.09.2019;99;112;13;88;4318;2500
4261;18.08.2019;85;123;38;69;3837;4095
4262;31.10.2019;4;14;10;28;3582;4869
4263;21.08.2019;19;54;35;35;3670;2447
4264;08.07.2019;61;91;30;67;914;3692
4265;07.10.2019;23;58;35;39;3148;1165
4266;11.06.2019;4;29;25;13;1165;2742
4267;28.07.2019;98;118;20;83;4922;698
4268;18.01.2020;91;119;28;76;81;3523
4269;09.02.2020;1;35;34;2;4282;3606
4270;29.01.2020;91;93;2;97;3602;4403
4271;09.02.2020;69;78;9;88;4676;2376
4272;21.11.2019;6;32;26;18;1452;1126
4273;17.10.2019;85;103;18;82;29;805
4274;02.03.2020;57;58;1;98;4611;532
4275;20.07.2019;16;33;17;48;3699;1218
4276;25.01.2020;64;77;13;83;4469;1373
4277;27.12.2019;16;49;33;32;4003;725
4278;25.03.2020;80;88;8;90;3341;221
4279;13.09.2019;69;109;40;63;4468;1822
4280;02.10.2019;73;107;34;68;1735;612
4281;09.11.2019;92;107;15;85;3180;3819
4282;02.11.2019;57;87;30;65;323;1182
4283;13.10.2019;48;53;5;90;1951;2318
4284;25.09.2019;78;104;26;75;4524;3880
4285;17.08.2019;81;95;14;85;2832;3134
4286;14.09.2019;42;71;29;59;744;2614
4287;20.11.2019;25;64;39;39;3486;1002
4288;14.07.2019;69;85;16;81;4509;1947
4289;26.04.2019;66;86;20;76;813;686
4290;04.03.2020;16;26;10;61;1436;820
4291;17.09.2019;67;75;8;89;288;3014
4292;17.03.2020;42;81;39;51;272;1833
4293;25.04.2019;91;95;4;95;2979;1785
4294;16.01.2020;97;120;23;80;2294;894
4295;25.04.2019;90;93;3;96;2801;2836
4296;24.06.2019;52;57;5;91;3749;3328
4297;20.08.2019;21;41;20;51;457;4051
4298;10.09.2019;11;49;38;22;2191;4422
4299;14.11.2019;94;118;24;79;890;2288
4300;17.01.2020;95;104;9;91;938;3061
4301;14.02.2020;56;62;6;90;2488;3171
4302;16.06.2019;31;37;6;83;2763;4076
4303;13.01.2020;32;46;14;69;1976;4545
4304;30.11.2019;10;12;2;83;3223;969
4305;04.06.2019;80;112;32;71;2653;2772
4306;26.11.2019;53;57;4;92;4187;3381
4307;28.02.2020;51;82;31;62;1941;583
4308;28.02.2020;70;83;13;84;2857;3836
4309;04.08.2019;6;24;18;25;1008;1187
4310;13.10.2019;92;128;36;71;1203;4561
4311;23.07.2019;55;64;9;85;1464;1999
4312;28.02.2020;25;27;2;92;4962;4174
4313;22.01.2020;65;74;9;87;2975;1627
4314;08.05.2019;14;17;3;82;902;205
4315;03.10.2019;71;76;5;93;3257;3989
4316;16.01.2020;47;82;35;57;1187;3776
4317;14.09.2019;22;60;38;36;1106;3
4318;18.02.2020;76;98;22;77;3002;4078
4319;14.02.2020;43;51;8;84;657;2211
4320;11.03.2020;18;54;36;33;322;4806
4321;21.06.2019;74;99;25;74;3741;2021
4322;10.05.2019;49;69;20;71;2638;609
4323;27.10.2019;85;92;7;92;1246;1028
4324;09.06.2019;37;65;28;56;4021;2832
4325;05.05.2019;78;107;29;72;3477;3128
4326;11.08.2019;92;126;34;73;2657;3209
4327;08.06.2019;74;86;12;86;3082;1514
4328;07.06.2019;36;48;12;75;1010;4829
4329;21.04.2019;58;97;39;59;3155;2393
4330;24.07.2019;80;106;26;75;2356;2738
4331;04.08.2019;95;107;12;88;4997;1917
4332;13.03.2020;53;78;25;67;2918;4926
4333;29.06.2019;66;73;7;90;1835;2427
4334;23.01.2020;65;87;22;74;828;828
4335;19.05.2019;7;14;7;50;4322;4779
4336;16.01.2020;39;54;15;72;442;637
4337;20.05.2019;20;34;14;58;2475;3578
4338;01.06.2019;25;37;12;67;1424;3601
4339;06.06.2019;51;87;36;58;21;3532
4340;30.06.2019;41;77;36;53;3178;4112
4341;23.09.2019;16;19;3;84;3188;1889
4342;10.04.2019;92;108;16;85;1121;1762
4343;24.02.2020;20;27;7;74;3789;135
4344;17.09.2019;78;98;20;79;2756;4174
4345;15.08.2019;82;120;38;68;4083;3908
4346;07.08.2019;60;96;36;62;1031;3164
4347;15.12.2019;88;122;34;72;2219;1425
4348;03.08.2019;76;105;29;72;3927;4837
4349;02.04.2019;88;121;33;72;2382;675
4350;11.09.2019;57;94;37;60;1846;41
4351;31.12.2019;87;90;3;96;2837;3117
4352;24.02.2020;41;80;39;51;4942;3194
4353;31.01.2020;35;51;16;68;4472;3994
4354;22.02.2020;90;123;33;73;3485;2988
4355;14.12.2019;35;63;28;55;3044;746
4356;18.05.2019;49;80;31;61;2504;481
4357;03.03.2020;58;65;7;89;4191;4746
4358;03.12.2019;82;119;37;68;2428;2307
4359;21.03.2020;13;48;35;27;3533;4852
4360;12.03.2020;59;78;19;75;1562;2869
4361;13.08.2019;83;109;26;76;2862;1647
4362;26.03.2020;97;124;27;78;2965;3083
4363;16.08.2019;94;110;16;85;3770;3350
4364;30.03.2019;1;24;23;4;3185;205
4365;04.10.2019;73;110;37;66;1005;582
4366;17.03.2020;7;42;35;16;806;3423
4367;03.11.2019;87;116;29;75;4700;3970
4368;08.12.2019;12;17;5;70;4505;107
4369;26.06.2019;21;61;40;34;1965;749
4370;11.08.2019;10;13;3;76;50;3772
4371;03.10.2019;49;89;40;55;1701;616
4372;07.09.2019;54;67;13;80;2636;4906
4373;31.10.2019;23;38;15;60;2919;3111
4374;06.04.2019;75;96;21;78;4721;4389
4375;13.12.2019;87;93;6;93;3008;2063
4376;10.12.2019;35;74;39;47;2578;4222
4377;22.03.2020;33;71;38;46;1767;1830
4378;28.03.2020;73;98;25;74;1019;3442
4379;06.04.2019;10;22;12;45;4615;4372
4380;18.03.2020;25;56;31;44;3871;202
4381;03.04.2019;51;71;20;71;3300;3532
4382;10.03.2020;44;56;12;78;1485;2971
4383;13.11.2019;32;66;34;48;3759;4815
4384;04.07.2019;80;87;7;91;458;4875
4385;20.08.2019;68;98;30;69;4743;1204
4386;17.07.2019;45;56;11;80;2462;3228
4387;26.06.2019;76;79;3;96;1908;1759
4388;23.02.2020;2;12;10;16;1143;1641
4389;02.12.2019;82;111;29;73;3662;4992
4390;04.01.2020;25;26;1;96;144;1789
4391;18.06.2019;42;63;21;66;3094;2646
4392;12.06.2019;42;47;5;89;1211;1155
4393;04.03.2020;13;25;12;52;860;3786
4394;20.01.2020;75;106;31;70;501;1220
4395;25.11.2019;26;64;38;40;1798;3411
4396;04.06.2019;70;80;10;87;1327;4346
4397;19.09.2019;8;12;4;66;2561;115
4398;20.11.2019;39;66;27;59;2300;739
4399;31.08.2019;16;46;30;34;4740;2590
4400;01.01.2020;32;71;39;45;3183;4383
4401;12.10.2019;37;64;27;57;614;4077
4402;09.05.2019;29;47;18;61;4531;3238
4403;10.07.2019;44;57;13;77;4429;4841
4404;08.04.2019;97;100;3;97;943;4400
4405;30.03.2019;25;57;32;43;2965;3190
4406;28.11.2019;90;121;31;74;2284;256
4407;19.11.2019;93;120;27;77;1137;162
4408;22.06.2019;48;61;13;78;2909;2620
4409;14.10.2019;73;96;23;76;4647;465
4410;04.06.2019;47;50;3;94;2603;2031
4411;05.08.2019;20;23;3;86;1690;310
4412;12.07.2019;76;108;32;70;3237;4348
4413;11.05.2019;39;74;35;52;3637;4149
4414;29.04.2019;94;129;35;72;559;496
4415;27.07.2019;20;22;2;90;1500;365
4416;07.08.2019;58;61;3;95;2367;4001
4417;15.06.2019;39;44;5;88;4800;4775
4418;16.02.2020;87;123;36;70;4554;1070
4419;18.11.2019;71;73;2;97;338;54
4420;17.06.2019;6;46;40;13;3005;2511
4421;22.03.2020;73;104;31;70;899;561
4422;05.06.2019;59;70;11;84;2618;4852
4423;13.12.2019;26;63;37;41;2172;815
4424;20.08.2019;63;80;17;78;2544;3715
4425;23.02.2020;95;109;14;87;3746;4307
4426;30.04.2019;94;101;7;93;1352;2884
4427;18.10.2019;97;126;29;76;4148;2626
4428;10.09.2019;98;123;25;79;2908;1133
4429;18.06.2019;70;103;33;67;4688;3767
4430;14.04.2019;82;113;31;72;3146;374
4431;27.02.2020;24;45;21;53;705;3568
4432;18.08.2019;69;75;6;92;2386;2290
4433;21.03.2020;26;55;29;47;2083;1804
4434;25.07.2019;25;60;35;41;3388;1388
4435;19.05.2019;23;57;34;40;2702;4432
4436;21.06.2019;29;41;12;70;4726;2000
4437;17.11.2019;60;97;37;61;2024;497
4438;26.12.2019;38;41;3;92;3568;3541
4439;01.05.2019;76;111;35;68;2641;1635
4440;22.07.2019;63;69;6;91;2733;119
4441;20.08.2019;61;65;4;93;3653;4589
4442;23.02.2020;82;93;11;88;718;1597
4443;03.06.2019;64;79;15;81;4257;4730
4444;25.05.2019;94;99;5;94;626;3612
4445;25.06.2019;35;68;33;51;3846;4358
4446;08.09.2019;34;52;18;65;1910;3944
4447;23.03.2020;17;32;15;53;3239;1073
4448;03.12.2019;9;46;37;19;2172;2379
4449;02.04.2019;60;90;30;66;3137;2078
4450;11.02.2020;16;31;15;51;3549;891
4451;21.05.2019;70;95;25;73;47;3115
4452;02.05.2019;49;55;6;89;1157;3568
4453;27.07.2019;91;120;29;75;2643;1034
4454;02.05.2019;92;113;21;81;1047;2284
4455;07.09.2019;69;82;13;84;2180;2812
4456;23.11.2019;74;113;39;65;2038;3983
4457;05.04.2019;21;42;21;50;1449;1837
4458;04.03.2020;16;22;6;72;4126;3820
4459;27.10.2019;34;67;33;50;4088;1599
4460;09.07.2019;65;72;7;90;143;1410
4461;11.07.2019;42;54;12;77;4731;1094
4462;14.03.2020;22;28;6;78;613;932
4463;27.01.2020;82;108;26;75;2037;682
4464;27.12.2019;98;116;18;84;997;869
4465;18.07.2019;13;20;7;65;4403;4645
4466;09.01.2020;21;54;33;38;511;1740
4467;20.11.2019;95;114;19;83;4594;4848
4468;17.02.2020;35;69;34;50;1096;217
4469;03.04.2019;36;73;37;49;2081;3959
4470;28.02.2020;37;64;27;57;1702;4493
4471;08.06.2019;100;130;30;76;4998;1036
4472;23.03.2020;35;65;30;53;3861;1156
4473;04.12.2019;73;90;17;81;2756;2184
4474;28.02.2020;95;128;33;74;3487;3119
4475;19.04.2019;69;97;28;71;2915;4471
4476;27.03.2020;81;101;20;80;1930;4197
4477;22.12.2019;47;85;38;55;1955;4754
4478;19.02.2020;54;90;36;60;2422;2705
4479;05.04.2019;25;56;31;44;1651;2816
4480;12.05.2019;33;54;21;61;4364;2006
4481;05.07.2019;18;20;2;90;2574;481
4482;27.05.2019;46;81;35;56;1666;1657
4483;21.08.2019;71;100;29;71;819;1154
4484;08.10.2019;80;120;40;66;2361;82
4485;12.03.2020;37;76;39;48;4718;2979
4486;22.10.2019;91;129;38;70;1737;1875
4487;06.01.2020;39;64;25;60;852;2219
4488;23.03.2020;80;117;37;68;1474;3955
4489;21.03.2020;75;90;15;83;2132;869
4490;04.05.2019;85;96;11;88;3059;279
4491;22.02.2020;28;35;7;80;990;507
4492;11.04.2019;63;76;13;82;4364;4068
4493;03.10.2019;20;50;30;40;976;4934
4494;01.04.2019;20;51;31;39;2312;1540
4495;28.06.2019;27;29;2;93;3751;19
4496;18.06.2019;36;73;37;49;1874;2158
4497;07.11.2019;96;134;38;71;276;3545
4498;26.12.2019;70;95;25;73;827;2758
4499;22.10.2019;46;82;36;56;4183;2041
4500;17.05.2019;97;106;9;91;3048;928
4501;03.10.2019;54;62;8;87;1384;1428
4502;13.10.2019;32;56;24;57;1753;2095
4503;04.02.2020;9;14;5;64;2852;4749
4504;03.02.2020;10;21;11;47;3350;3226
4505;11.05.2019;86;92;6;93;4047;4435
4506;19.07.2019;72;92;20;78;372;4344
4507;03.11.2019;70;98;28;71;4878;3593
4508;08.02.2020;91;99;8;91;983;3234
4509;08.08.2019;35;45;10;77;2890;4138
4510;03.11.2019;16;54;38;29;4134;3841
4511;09.12.2019;53;88;35;60;1270;1528
4512;01.04.2019;67;75;8;89;2286;2292
4513;28.06.2019;76;83;7;91;1666;2337
4514;11.12.2019;34;66;32;51;1311;1364
4515;19.07.2019;76;103;27;73;1962;3075
4516;02.04.2019;77;88;11;87;235;1232
4517;09.09.2019;85;100;15;85;3272;4548
4518;30.05.2019;66;82;16;80;2308;394
4519;15.02.2020;28;34;6;82;1711;3511
4520;27.08.2019;30;34;4;88;2648;2298
4521;20.06.2019;19;21;2;90;811;934
4522;23.08.2019;7;13;6;53;4507;416
4523;23.11.2019;52;62;10;83;4435;1154
4524;22.06.2019;53;55;2;96;4712;4866
4525;05.11.2019;53;66;13;80;2102;1330
4526;20.11.2019;68;79;11;86;1394;2899
4527;15.10.2019;65;103;38;63;587;3859
4528;02.12.2019;52;89;37;58;4488;554
4529;24.10.2019;33;35;2;94;3680;1578
4530;21.08.2019;40;61;21;65;160;649
4531;05.09.2019;39;61;22;63;4194;2753
4532;11.10.2019;79;91;12;86;1848;3615
4533;17.07.2019;59;61;2;96;98;1216
4534;25.05.2019;30;65;35;46;4237;603
4535;18.09.2019;88;127;39;69;1391;3281
4536;02.05.2019;43;45;2;95;1920;2142
4537;19.10.2019;11;32;21;34;1214;3133
4538;10.10.2019;20;22;2;90;3086;587
4539;10.01.2020;89;117;28;76;288;2863
4540;18.09.2019;63;93;30;67;783;3235
4541;09.03.2020;9;23;14;39;3538;3407
4542;21.10.2019;69;89;20;77;775;670
4543;20.12.2019;88;110;22;80;2550;4654
4544;05.06.2019;59;70;11;84;4945;4021
4545;17.11.2019;3;31;28;9;1077;1802
4546;12.08.2019;31;38;7;81;4937;2320
4547;04.02.2020;71;95;24;74;1458;4297
4548;01.08.2019;96;132;36;72;2919;3640
4549;31.05.2019;88;95;7;92;324;841
4550;08.02.2020;30;41;11;73;133;1629
4551;08.06.2019;99;121;22;81;4608;4674
4552;09.04.2019;6;21;15;28;3908;4172
4553;03.11.2019;65;104;39;62;1528;1868
4554;28.12.2019;76;80;4;95;1507;4452
4555;16.04.2019;40;47;7;85;4387;4027
4556;24.05.2019;15;39;24;38;2768;2035
4557;26.02.2020;7;35;28;20;1267;4664
4558;08.10.2019;68;77;9;88;1636;1223
4559;02.08.2019;73;84;11;86;1311;4466
4560;14.09.2019;11;51;40;21;1740;1487
4561;25.11.2019;84;104;20;80;1277;3849
4562;07.08.2019;77;93;16;82;2278;2733
4563;16.10.2019;93;96;3;96;1218;1419
4564;23.04.2019;92;127;35;72;50;3004
4565;08.07.2019;8;41;33;19;2629;294
4566;10.02.2020;65;82;17;79;829;1548
4567;09.02.2020;74;105;31;70;1104;1961
4568;19.12.2019;95;105;10;90;785;3231
4569;22.03.2020;99;112;13;88;534;1450
4570;28.04.2019;4;13;9;30;4752;319
4571;30.08.2019;5;17;12;29;2461;1943
4572;09.05.2019;75;94;19;79;3399;933
4573;29.05.2019;85;111;26;76;4187;1116
4574;01.02.2020;12;32;20;37;254;4852
4575;20.01.2020;79;81;2;97;43;662
4576;06.08.2019;6;46;40;13;2174;1557
4577;18.01.2020;71;84;13;84;916;988
4578;20.08.2019;63;70;7;90;825;885
4579;30.05.2019;74;113;39;65;2458;2928
4580;15.06.2019;47;80;33;58;2128;583
4581;20.10.2019;55;79;24;69;3091;170
4582;09.06.2019;29;64;35;45;3584;1642
4583;27.08.2019;84;124;40;67;1899;4453
4584;27.09.2019;6;10;4;60;1784;2275
4585;09.12.2019;48;50;2;96;4238;691
4586;04.01.2020;44;52;8;84;1042;3205
4587;18.05.2019;2;24;22;8;2031;820
4588;23.08.2019;71;79;8;89;2394;1354
4589;05.06.2019;62;65;3;95;3821;3653
4590;11.10.2019;35;64;29;54;604;867
4591;01.09.2019;61;81;20;75;3114;2768
4592;08.05.2019;85;121;36;70;4174;1074
4593;10.02.2020;39;69;30;56;4343;4748
4594;04.11.2019;94;116;22;81;1665;1704
4595;24.10.2019;85;90;5;94;3952;2704
4596;22.01.2020;97;115;18;84;1838;2307
4597;08.12.2019;41;72;31;56;4970;3309
4598;01.12.2019;77;108;31;71;1314;1835
4599;23.10.2019;25;28;3;89;2429;1711
4600;03.04.2019;95;128;33;74;753;465
4601;03.06.2019;63;94;31;67;2272;3313
4602;23.02.2020;31;45;14;68;3990;1508
4603;27.11.2019;77;101;24;76;2119;3643
4604;02.01.2020;12;31;19;38;2957;1506
4605;16.03.2020;19;34;15;55;3951;4745
4606;05.11.2019;95;118;23;80;694;1605
4607;22.09.2019;71;107;36;66;290;4322
4608;24.11.2019;12;23;11;52;3820;3873
4609;14.10.2019;92;98;6;93;1291;4610
4610;30.10.2019;75;89;14;84;183;4971
4611;17.10.2019;39;51;12;76;2777;2301
4612;01.04.2019;66;71;5;92;2920;4567
4613;14.03.2020;62;84;22;73;3179;1492
4614;31.05.2019;16;49;33;32;3806;346
4615;07.11.2019;46;49;3;93;4373;4046
4616;22.04.2019;43;75;32;57;4109;3376
4617;02.10.2019;88;102;14;86;3054;3978
4618;16.10.2019;92;98;6;93;3183;2711
4619;07.05.2019;47;81;34;58;4439;495
4620;19.12.2019;97;113;16;85;3913;3488
4621;16.09.2019;15;50;35;30;4884;4075
4622;19.08.2019;100;117;17;85;635;3363
4623;06.01.2020;15;20;5;75;4800;2014
4624;09.06.2019;98;112;14;87;4608;1359
4625;22.03.2020;84;99;15;84;464;4026
4626;02.11.2019;10;36;26;27;4395;4654
4627;10.04.2019;26;50;24;52;3715;1924
4628;29.10.2019;88;121;33;72;3433;987
4629;02.03.2020;79;84;5;94;2282;3741
4630;22.11.2019;27;45;18;60;4466;3119
4631;30.09.2019;9;20;11;45;2800;1370
4632;03.12.2019;92;109;17;84;4729;3691
4633;07.11.2019;97;115;18;84;81;3575
4634;01.07.2019;16;32;16;50;333;3309
4635;20.02.2020;41;69;28;59;1588;1964
4636;08.08.2019;56;91;35;61;172;1355
4637;05.06.2019;9;49;40;18;1075;918
4638;01.10.2019;76;79;3;96;4108;2818
4639;29.03.2019;75;113;38;66;711;2287
4640;27.07.2019;41;75;34;54;2007;4097
4641;20.07.2019;97;119;22;81;462;3714
4642;24.10.2019;35;53;18;66;454;1266
4643;15.09.2019;85;101;16;84;3372;3440
4644;27.02.2020;98;103;5;95;2329;1387
4645;04.09.2019;7;12;5;58;2617;2200
4646;26.07.2019;45;58;13;77;4823;439
4647;17.09.2019;17;38;21;44;443;4574
4648;07.03.2020;32;61;29;52;2913;4068
4649;07.07.2019;92;106;14;86;1834;2402
4650;25.07.2019;59;74;15;79;2986;1175
4651;13.09.2019;1;26;25;3;1699;4476
4652;27.12.2019;79;111;32;71;3942;1497
4653;08.11.2019;54;74;20;72;4259;1516
4654;27.07.2019;53;73;20;72;2049;3328
4655;03.10.2019;78;89;11;87;570;1704
4656;22.05.2019;96;119;23;80;2702;4243
4657;19.02.2020;82;91;9;90;4009;2163
4658;05.11.2019;26;34;8;76;377;1041
4659;19.06.2019;72;82;10;87;631;3212
4660;29.10.2019;49;89;40;55;3114;3893
4661;04.08.2019;16;37;21;43;4888;1657
4662;08.08.2019;96;120;24;80;1993;4597
4663;15.05.2019;19;34;15;55;1032;3781
4664;30.03.2019;1;22;21;4;2909;4132
4665;21.11.2019;19;37;18;51;1173;4465
4666;18.09.2019;85;87;2;97;4996;610
4667;09.07.2019;6;46;40;13;1248;1442
4668;24.10.2019;38;67;29;56;1844;641
4669;09.03.2020;29;52;23;55;4234;3385
4670;25.08.2019;39;59;20;66;2161;3753
4671;09.06.2019;4;18;14;22;1265;1859
4672;26.12.2019;50;86;36;58;4370;940
4673;04.11.2019;6;40;34;15;548;3110
4674;29.07.2019;81;84;3;96;1826;1670
4675;31.12.2019;77;92;15;83;4095;3988
4676;03.08.2019;45;66;21;68;4078;2803
4677;11.02.2020;5;45;40;11;3053;4478
4678;24.01.2020;45;83;38;54;211;3939
4679;04.07.2019;39;77;38;50;1813;2889
4680;06.08.2019;78;115;37;67;3306;1904
4681;27.02.2020;21;41;20;51;1891;793
4682;27.06.2019;3;20;17;15;4464;3348
4683;12.11.2019;70;86;16;81;416;4006
4684;21.02.2020;19;29;10;65;4203;2412
4685;24.08.2019;65;87;22;74;257;4329
4686;25.04.2019;1;10;9;10;2138;2214
4687;25.01.2020;26;37;11;70;1348;182
4688;26.08.2019;20;26;6;76;3442;1227
4689;24.07.2019;28;38;10;73;2002;4971
4690;15.12.2019;49;73;24;67;787;112
4691;04.03.2020;99;121;22;81;2223;4901
4692;03.07.2019;1;2;1;50;1852;4618
4693;08.11.2019;57;78;21;73;3409;3266
4694;27.09.2019;43;62;19;69;2700;249
4695;12.10.2019;26;48;22;54;4044;1128
4696;06.04.2019;46;57;11;80;2371;2165
4697;19.11.2019;95;123;28;77;3944;3500
4698;12.01.2020;84;108;24;77;1849;4965
4699;28.06.2019;2;8;6;25;4223;2168
4700;07.01.2020;76;95;19;80;230;2271
4701;07.04.2019;35;65;30;53;2133;4260
4702;06.11.2019;96;120;24;80;3169;4953
4703;26.08.2019;72;101;29;71;2944;2136
4704;17.12.2019;17;23;6;73;314;1536
4705;04.10.2019;45;77;32;58;3192;1974
4706;29.10.2019;36;73;37;49;854;1645
4707;30.11.2019;75;104;29;72;1623;1485
4708;11.09.2019;77;108;31;71;300;2949
4709;30.09.2019;95;125;30;76;2971;4840
4710;03.11.2019;7;25;18;28;1856;3698
4711;22.03.2020;66;97;31;68;4321;1814
4712;12.12.2019;7;16;9;43;4142;3231
4713;24.10.2019;34;56;22;60;2484;26
4714;01.10.2019;19;27;8;70;3575;4103
4715;23.08.2019;81;109;28;74;2863;3956
4716;11.07.2019;33;53;20;62;484;1910
4717;16.10.2019;27;67;40;40;4564;339
4718;20.04.2019;89;107;18;83;4957;1112
4719;12.12.2019;32;49;17;65;3282;4970
4720;04.04.2019;37;76;39;48;3805;966
4721;10.09.2019;33;39;6;84;3580;1164
4722;05.06.2019;86;119;33;72;4079;2909
4723;29.07.2019;99;106;7;93;1277;3079
4724;29.05.2019;74;87;13;85;735;4632
4725;19.06.2019;90;121;31;74;3476;3693
4726;26.09.2019;18;54;36;33;2297;672
4727;11.12.2019;93;121;28;76;365;3445
4728;12.08.2019;24;61;37;39;2812;1788
4729;24.03.2020;15;30;15;50;1456;597
4730;24.03.2020;2;37;35;5;4073;3460
4731;12.09.2019;41;54;13;75;2702;3672
4732;24.12.2019;72;100;28;72;411;4619
4733;03.12.2019;77;86;9;89;3745;4252
4734;04.06.2019;52;92;40;56;3978;4187
4735;19.11.2019;40;54;14;74;2800;3856
4736;03.07.2019;83;89;6;93;2666;1759
4737;20.01.2020;93;96;3;96;2885;2808
4738;24.04.2019;30;42;12;71;4072;1709
4739;25.01.2020;5;16;11;31;2155;4321
4740;18.03.2020;61;80;19;76;592;2933
4741;07.07.2019;30;61;31;49;462;2450
4742;11.10.2019;88;105;17;83;4300;74
4743;08.08.2019;81;98;17;82;4380;634
4744;20.05.2019;97;111;14;87;507;1172
4745;20.03.2020;61;91;30;67;29;2243
4746;23.08.2019;73;75;2;97;3515;922
4747;13.11.2019;52;92;40;56;3317;1485
4748;24.09.2019;28;59;31;47;2880;3672
4749;18.12.2019;21;27;6;77;4830;3887
4750;31.12.2019;24;30;6;80;2264;183
4751;17.06.2019;70;77;7;90;429;1221
4752;11.10.2019;56;68;12;82;2202;4072
4753;19.05.2019;71;95;24;74;447;568
4754;08.04.2019;5;35;30;14;4840;1136
4755;31.08.2019;59;86;27;68;4381;2528
4756;27.01.2020;66;100;34;66;3905;1933
4757;18.07.2019;20;36;16;55;34;236
4758;24.01.2020;53;81;28;65;307;3287
4759;02.06.2019;25;44;19;56;211;186
4760;04.05.2019;100;126;26;79;425;2775
4761;06.05.2019;3;39;36;7;4360;2468
4762;17.09.2019;68;104;36;65;2714;279
4763;23.11.2019;14;17;3;82;2877;2477
4764;20.01.2020;61;65;4;93;291;4081
4765;28.04.2019;44;75;31;58;975;4428
4766;12.05.2019;14;21;7;66;374;1272
4767;22.11.2019;10;41;31;24;2867;4456
4768;15.07.2019;37;50;13;74;1615;248
4769;22.07.2019;45;52;7;86;3567;1015
4770;06.09.2019;21;59;38;35;3997;3858
4771;17.02.2020;98;132;34;74;1816;3089
4772;17.08.2019;36;56;20;64;293;293
4773;08.04.2019;16;31;15;51;4788;2871
4774;09.05.2019;20;28;8;71;2821;4136
4775;17.03.2020;53;54;1;98;4389;2924
4776;11.01.2020;10;20;10;50;1395;4880
4777;15.09.2019;46;58;12;79;3964;4603
4778;09.10.2019;50;78;28;64;3933;580
4779;18.12.2019;54;57;3;94;4472;251
4780;26.10.2019;37;39;2;94;4788;2809
4781;06.01.2020;62;95;33;65;4024;2943
4782;14.10.2019;16;48;32;33;4784;1244
4783;20.04.2019;38;63;25;60;2521;614
4784;23.02.2020;11;15;4;73;169;2544
4785;29.03.2019;38;61;23;62;867;2104
4786;13.04.2019;88;114;26;77;3654;2951
4787;22.06.2019;60;95;35;63;2912;3191
4788;24.12.2019;4;39;35;10;160;2444
4789;06.10.2019;78;117;39;66;2551;725
4790;15.04.2019;2;34;32;5;3618;2857
4791;12.11.2019;11;51;40;21;298;4487
4792;02.11.2019;86;117;31;73;3621;3119
4793;26.03.2020;37;62;25;59;4196;2912
4794;13.02.2020;21;54;33;38;242;4585
4795;02.12.2019;7;33;26;21;267;4947
4796;28.09.2019;50;65;15;76;4762;543
4797;19.06.2019;50;64;14;78;4893;1350
4798;11.10.2019;42;71;29;59;3077;2882
4799;08.02.2020;24;53;29;45;410;2089
4800;16.06.2019;37;69;32;53;4729;3131
4801;14.07.2019;41;68;27;60;2350;1646
4802;11.01.2020;71;74;3;95;687;3520
4803;10.01.2020;65;91;26;71;3391;2004
4804;15.07.2019;89;125;36;71;313;4492
4805;22.03.2020;55;90;35;61;3486;532
4806;20.12.2019;1;41;40;2;4417;1323
4807;03.03.2020;1;11;10;9;870;3069
4808;23.12.2019;53;68;15;77;271;4451
4809;31.07.2019;26;61;35;42;557;1184
4810;27.09.2019;24;36;12;66;1502;4955
4811;10.10.2019;40;63;23;63;941;4334
4812;30.11.2019;86;87;1;98;1462;98
4813;24.12.2019;35;40;5;87;2188;2808
4814;24.12.2019;23;29;6;79;3835;383
4815;28.12.2019;50;88;38;56;2412;1864
4816;20.02.2020;79;100;21;79;3896;3567
4817;22.04.2019;97;131;34;74;3781;1489
4818;19.02.2020;51;90;39;56;4587;1707
4819;27.04.2019;55;89;34;61;608;504
4820;19.09.2019;68;85;17;80;383;3678
4821;20.12.2019;71;109;38;65;1903;1060
4822;06.06.2019;23;49;26;46;2618;4879
4823;21.11.2019;63;91;28;69;4876;4234
4824;02.02.2020;87;111;24;78;2773;4715
4825;09.09.2019;50;72;22;69;3646;1204
4826;21.06.2019;56;75;19;74;2750;1807
4827;16.01.2020;8;41;33;19;3787;2057
4828;30.03.2019;98;120;22;81;1083;1343
4829;22.03.2020;75;83;8;90;3397;3614
4830;03.09.2019;41;59;18;69;4546;4009
4831;11.10.2019;98;126;28;77;382;3858
4832;26.07.2019;27;55;28;49;3583;3763
4833;11.10.2019;15;46;31;32;1495;4145
4834;08.06.2019;31;34;3;91;1120;5
4835;21.07.2019;47;77;30;61;4869;2639
4836;31.12.2019;8;23;15;34;2382;4997
4837;26.10.2019;66;94;28;70;650;1620
4838;28.04.2019;49;78;29;62;1072;4559
4839;07.08.2019;69;107;38;64;1042;1667
4840;28.09.2019;52;72;20;72;2519;4695
4841;07.07.2019;40;80;40;50;2439;1747
4842;30.10.2019;38;59;21;64;4054;1233
4843;26.02.2020;77;113;36;68;176;1038
4844;26.10.2019;36;43;7;83;1891;4593
4845;06.05.2019;43;55;12;78;4672;2775
4846;30.03.2019;91;109;18;83;2307;944
4847;12.07.2019;5;8;3;62;892;659
4848;19.06.2019;42;67;25;62;4142;4029
4849;15.07.2019;57;77;20;74;4626;3343
4850;03.11.2019;90;127;37;70;3308;862
4851;02.02.2020;55;69;14;79;3213;4093
4852;28.03.2020;14;34;20;41;2534;3912
4853;16.06.2019;7;32;25;21;2122;3416
4854;08.06.2019;35;45;10;77;1768;2169
4855;13.05.2019;54;76;22;71;4818;1822
4856;20.12.2019;30;50;20;60;396;1231
4857;20.07.2019;72;79;7;91;4031;1832
4858;19.01.2020;31;54;23;57;2128;1227
4859;12.02.2020;96;131;35;73;1136;449
4860;09.10.2019;55;89;34;61;1105;2333
4861;05.10.2019;11;34;23;32;4657;3964
4862;08.05.2019;76;94;18;80;3056;4755
4863;06.08.2019;53;85;32;62;1802;3502
4864;08.05.2019;43;74;31;58;590;2641
4865;29.02.2020;76;101;25;75;2501;1922
4866;10.07.2019;4;15;11;26;2567;2985
4867;27.06.2019;57;94;37;60;3109;2134
4868;16.01.2020;84;120;36;70;4742;1457
4869;04.08.2019;85;123;38;69;70;4120
4870;10.04.2019;22;37;15;59;173;233
4871;18.07.2019;30;46;16;65;146;3860
4872;24.10.2019;4;5;1;80;1084;1111
4873;10.08.2019;99;134;35;73;1133;1332
4874;28.11.2019;52;65;13;80;398;2106
4875;23.05.2019;12;28;16;42;3414;4779
4876;30.06.2019;86;92;6;93;2537;2770
4877;29.02.2020;8;32;24;25;1967;1371
4878;28.04.2019;54;93;39;58;2939;2908
4879;19.07.2019;25;58;33;43;2126;4106
4880;11.04.2019;68;103;35;66;2053;2797
4881;17.08.2019;38;64;26;59;3329;4041
4882;06.01.2020;79;112;33;70;2276;1475
4883;15.05.2019;16;35;19;45;3572;729
4884;05.03.2020;77;87;10;88;1887;1662
4885;10.08.2019;7;35;28;20;110;3742
4886;05.02.2020;20;58;38;34;4723;2508
4887;22.09.2019;48;62;14;77;3000;1789
4888;18.05.2019;59;87;28;67;2379;120
4889;26.11.2019;81;112;31;72;3595;4940
4890;20.05.2019;50;90;40;55;2659;2431
4891;07.06.2019;12;45;33;26;1779;77
4892;12.01.2020;81;107;26;75;4656;539
4893;15.04.2019;70;78;8;89;1713;895
4894;01.06.2019;69;87;18;79;2463;956
4895;19.11.2019;37;71;34;52;2359;1919
4896;09.11.2019;6;12;6;50;1180;2027
4897;05.12.2019;56;66;10;84;3562;111
4898;31.03.2019;71;96;25;73;2540;1720
4899;01.06.2019;41;62;21;66;4754;2935
4900;15.09.2019;19;59;40;32;2661;46
4901;16.01.2020;69;98;29;70;101;2005
4902;11.06.2019;51;79;28;64;1157;1095
4903;27.10.2019;84;89;5;94;2422;1761
4904;20.04.2019;61;89;28;68;1613;1191
4905;18.05.2019;16;28;12;57;1741;4075
4906;07.02.2020;56;87;31;64;1269;4597
4907;26.06.2019;31;54;23;57;4451;3582
4908;13.06.2019;25;59;34;42;2350;69
4909;07.08.2019;26;30;4;86;3763;574
4910;24.09.2019;1;40;39;2;387;3713
4911;05.12.2019;36;48;12;75;4736;2589
4912;02.09.2019;50;82;32;60;3040;4909
4913;09.06.2019;40;47;7;85;1713;3523
4914;28.11.2019;21;33;12;63;457;1661
4915;11.01.2020;35;39;4;89;2760;2859
4916;12.11.2019;12;37;25;32;523;112
4917;27.07.2019;78;105;27;74;3291;985
4918;03.03.2020;54;60;6;90;327;759
4919;23.08.2019;94;132;38;71;1365;2418
4920;02.01.2020;37;67;30;55;1304;1207
4921;06.05.2019;39;67;28;58;1494;3128
4922;28.02.2020;88;98;10;89;1922;941
4923;23.10.2019;98;122;24;80;2348;3504
4924;23.01.2020;74;105;31;70;3957;2521
4925;31.01.2020;95;122;27;77;350;3964
4926;23.06.2019;46;61;15;75;1182;3289
4927;22.07.2019;10;24;14;41;4795;599
4928;04.01.2020;82;110;28;74;4517;2
4929;18.10.2019;95;102;7;93;2909;1873
4930;03.09.2019;59;81;22;72;231;3782
4931;16.10.2019;42;61;19;68;1292;3176
4932;10.04.2019;26;28;2;92;1982;303
4933;09.01.2020;86;123;37;69;2309;4785
4934;25.07.2019;93;113;20;82;2431;4694
4935;09.07.2019;61;69;8;88;2942;60
4936;01.06.2019;53;74;21;71;927;1088
4937;21.07.2019;1;10;9;10;4291;2737
4938;03.09.2019;31;38;7;81;1594;3713
4939;28.09.2019;50;70;20;71;3706;3317
4940;16.05.2019;37;60;23;61;903;3720
4941;14.09.2019;56;91;35;61;4077;4958
4942;26.07.2019;33;43;10;76;1616;186
4943;24.10.2019;42;50;8;84;1635;1744
4944;02.06.2019;71;108;37;65;1942;2277
4945;25.03.2020;70;76;6;92;4648;2186
4946;04.06.2019;8;13;5;61;3366;808
4947;08.12.2019;25;28;3;89;3891;2224
4948;18.12.2019;91;126;35;72;3188;908
4949;14.12.2019;2;16;14;12;2173;4103
4950;15.11.2019;20;25;5;80;4240;2492
4951;10.02.2020;88;109;21;80;1168;2062
4952;27.05.2019;95;115;20;82;2924;1709
4953;07.12.2019;99;105;6;94;4454;2822
4954;08.02.2020;38;67;29;56;906;3454
4955;12.07.2019;18;34;16;52;233;3093
4956;26.04.2019;60;64;4;93;269;3065
4957;28.10.2019;26;40;14;65;2263;2517
4958;23.06.2019;86;88;2;97;4208;1737
4959;14.12.2019;87;119;32;73;537;1313
4960;28.04.2019;28;49;21;57;4358;4016
4961;26.12.2019;91;107;16;85;1418;1250
4962;19.07.2019;66;78;12;84;3664;4791
4963;10.04.2019;63;95;32;66;1575;2551
4964;08.06.2019;26;35;9;74;3149;1735
4965;22.05.2019;8;32;24;25;968;2422
4966;24.11.2019;7;39;32;17;4531;2035
4967;25.07.2019;80;88;8;90;1684;2582
4968;06.08.2019;3;22;19;13;1083;3463
4969;22.10.2019;19;28;9;67;4531;880
4970;25.08.2019;37;39;2;94;2485;588
4971;16.01.2020;11;22;11;50;4753;1481
4972;29.09.2019;48;50;2;96;904;3585
4973;12.01.2020;69;97;28;71;4654;3314
4974;19.02.2020;40;68;28;58;2999;1730
4975;04.09.2019;52;69;17;75;3534;2603
4976;18.10.2019;4;31;27;12;4828;1058
4977;11.08.2019;43;68;25;63;2013;4488
4978;16.05.2019;21;46;25;45;791;502
4979;22.03.2020;73;88;15;82;396;943
4980;06.10.2019;100;123;23;81;3334;1835
4981;20.03.2020;69;85;16;81;1345;2997
4982;27.11.2019;51;87;36;58;4592;1300
4983;16.11.2019;33;51;18;64;2911;3573
4984;18.12.2019;44;83;39;53;4456;3599
4985;02.04.2019;63;73;10;86;642;3717
4986;09.12.2019;28;63;35;44;3783;4034
4987;04.01.2020;74;75;1;98;950;2221
4988;03.09.2019;25;31;6;80;668;4794
4989;19.11.2019;80;91;11;87;1619;658
4990;02.07.2019;95;121;26;78;2202;1449
4991;25.02.2020;65;73;8;89;569;1636
4992;02.04.2019;88;117;29;75;1697;1676
4993;15.04.2019;82;113;31;72;4466;2816
4994;19.04.2019;20;39;19;51;3564;1098
4995;08.10.2019;85;104;19;81;2164;1051
4996;31.03.2019;87;117;30;74;4224;458
4997;12.11.2019;91;112;21;81;2478;4007
4998;18.09.2019;61;87;26;70;1738;3310
4999;30.06.2019;63;94;31;67;1175;2221
5000;17.07.2019;97;106;9;91;4925;138
